"filename", "language", "JavaScript", "TypeScript JSX", "Markdown", "HTML", "CSS", "comment", "blank", "total"
"c:\Users\Administrator\Desktop\bakalauras\JourneyFy\README.md", "Markdown", 0, 0, -17, 0, 0, 0, -4, -21
"c:\Users\Administrator\Desktop\bakalauras\JourneyFy\_tests_\Component\AddVehicle\ImagePickerBottomSheet.test.js", "JavaScript", -17, 0, 0, 0, 0, 0, -2, -19
"c:\Users\Administrator\Desktop\bakalauras\JourneyFy\_tests_\Component\AddVehicle\VehicleForm.test.js", "JavaScript", -17, 0, 0, 0, 0, 0, -2, -19
"c:\Users\Administrator\Desktop\bakalauras\JourneyFy\_tests_\Component\BankInfo\AccountNumberInput.test.js", "JavaScript", -16, 0, 0, 0, 0, -4, -2, -22
"c:\Users\Administrator\Desktop\bakalauras\JourneyFy\_tests_\Component\BankInfo\SubmitButton.test.js", "JavaScript", -13, 0, 0, 0, 0, -1, -2, -16
"c:\Users\Administrator\Desktop\bakalauras\JourneyFy\_tests_\Component\BottomTabBarScreen.test.js", "JavaScript", -23, 0, 0, 0, 0, -1, -4, -28
"c:\Users\Administrator\Desktop\bakalauras\JourneyFy\_tests_\Component\CreditCard\CreditCardForm.test.js", "JavaScript", -28, 0, 0, 0, 0, -4, -5, -37
"c:\Users\Administrator\Desktop\bakalauras\JourneyFy\_tests_\Component\CustomerSupport\SupportForm.test.js", "JavaScript", -10, 0, 0, 0, 0, 0, -2, -12
"c:\Users\Administrator\Desktop\bakalauras\JourneyFy\_tests_\Component\EndRide\EndRideButton.test.js", "JavaScript", -52, 0, 0, 0, 0, -3, -8, -63
"c:\Users\Administrator\Desktop\bakalauras\JourneyFy\_tests_\Component\EndRide\MapDirection.test.js", "JavaScript", -37, 0, 0, 0, 0, -4, -4, -45
"c:\Users\Administrator\Desktop\bakalauras\JourneyFy\_tests_\Component\EndRide\PassengerList.test.js", "JavaScript", -23, 0, 0, 0, 0, -3, -3, -29
"c:\Users\Administrator\Desktop\bakalauras\JourneyFy\_tests_\Component\EndRide\RideInfoSheet.test.js", "JavaScript", -28, 0, 0, 0, 0, -6, -6, -40
"c:\Users\Administrator\Desktop\bakalauras\JourneyFy\_tests_\Component\EndRide\RouteList.test.js", "JavaScript", -35, 0, 0, 0, 0, -7, -4, -46
"c:\Users\Administrator\Desktop\bakalauras\JourneyFy\_tests_\Component\Entry\EntryButton.test.js", "JavaScript", -29, 0, 0, 0, 0, -5, -4, -38
"c:\Users\Administrator\Desktop\bakalauras\JourneyFy\_tests_\Component\Entry\EntryInputField.test.js", "JavaScript", -52, 0, 0, 0, 0, -12, -8, -72
"c:\Users\Administrator\Desktop\bakalauras\JourneyFy\_tests_\Component\Header.test.js", "JavaScript", -18, 0, 0, 0, 0, -3, -5, -26
"c:\Users\Administrator\Desktop\bakalauras\JourneyFy\_tests_\Component\HistoryRideDetail\RateRideDialog.test.js", "JavaScript", -14, 0, 0, 0, 0, -5, 2, -17
"c:\Users\Administrator\Desktop\bakalauras\JourneyFy\_tests_\Component\HistoryRideDetail\RiderDetail.test.js", "JavaScript", -20, 0, 0, 0, 0, -6, -5, -31
"c:\Users\Administrator\Desktop\bakalauras\JourneyFy\_tests_\Component\Home\DateTimePickerSheet.test.js", "JavaScript", -53, 0, 0, 0, 0, -5, -9, -67
"c:\Users\Administrator\Desktop\bakalauras\JourneyFy\_tests_\Component\Home\Header.test.js", "JavaScript", -36, 0, 0, 0, 0, -3, -6, -45
"c:\Users\Administrator\Desktop\bakalauras\JourneyFy\_tests_\Component\Home\RideInfoCard.test.js", "JavaScript", -22, 0, 0, 0, 0, -5, 1, -26
"c:\Users\Administrator\Desktop\bakalauras\JourneyFy\_tests_\Component\LoadingIndicator.test.js", "JavaScript", -13, 0, 0, 0, 0, 0, -2, -15
"c:\Users\Administrator\Desktop\bakalauras\JourneyFy\_tests_\Component\Message\MessageHeader.test.js", "JavaScript", -42, 0, 0, 0, 0, -9, -6, -57
"c:\Users\Administrator\Desktop\bakalauras\JourneyFy\_tests_\Component\Message\MessageInput.test.js", "JavaScript", -22, 0, 0, 0, 0, -5, -5, -32
"c:\Users\Administrator\Desktop\bakalauras\JourneyFy\_tests_\Component\Message\MessageItemAndList.test.js", "JavaScript", -50, 0, 0, 0, 0, -8, -7, -65
"c:\Users\Administrator\Desktop\bakalauras\JourneyFy\_tests_\Component\MyStatusBar.test.js", "JavaScript", -16, 0, 0, 0, 0, 0, -3, -19
"c:\Users\Administrator\Desktop\bakalauras\JourneyFy\_tests_\Component\OfferRide\CarInfo.test.js", "JavaScript", -46, 0, 0, 0, 0, -1, -13, -60
"c:\Users\Administrator\Desktop\bakalauras\JourneyFy\_tests_\Component\OfferRide\LocationInfo.test.js", "JavaScript", -19, 0, 0, 0, 0, -1, -4, -24
"c:\Users\Administrator\Desktop\bakalauras\JourneyFy\_tests_\Component\OfferRide\PriceInfo.test.js", "JavaScript", -15, 0, 0, 0, 0, -1, -2, -18
"c:\Users\Administrator\Desktop\bakalauras\JourneyFy\_tests_\Component\OfferRide\SeatSelectionSheet.test.js", "JavaScript", -29, 0, 0, 0, 0, -1, -5, -35
"c:\Users\Administrator\Desktop\bakalauras\JourneyFy\_tests_\Component\PaymentMethods\PaymentMethodItem.test.js", "JavaScript", -43, 0, 0, 0, 0, -5, -8, -56
"c:\Users\Administrator\Desktop\bakalauras\JourneyFy\_tests_\Component\PickLocation\LocationSearchHeader.test.js", "JavaScript", -49, 0, 0, 0, 0, -6, -5, -60
"c:\Users\Administrator\Desktop\bakalauras\JourneyFy\_tests_\Component\PickLocation\PickLocationMap.test.js", "JavaScript", -41, 0, 0, 0, 0, -3, -5, -49
"c:\Users\Administrator\Desktop\bakalauras\JourneyFy\_tests_\Component\Profile\Divider.test.js", "JavaScript", -14, 0, 0, 0, 0, -1, -2, -17
"c:\Users\Administrator\Desktop\bakalauras\JourneyFy\_tests_\Component\Profile\ProfileInputField.test.js", "JavaScript", -54, 0, 0, 0, 0, -3, -6, -63
"c:\Users\Administrator\Desktop\bakalauras\JourneyFy\_tests_\Component\Profile\ProfilePicture.test.js", "JavaScript", -35, 0, 0, 0, 0, -3, -4, -42
"c:\Users\Administrator\Desktop\bakalauras\JourneyFy\_tests_\Component\RideDetail\CancelRideDialog.test.js", "JavaScript", -23, 0, 0, 0, 0, -3, -7, -33
"c:\Users\Administrator\Desktop\bakalauras\JourneyFy\_tests_\Component\RideDetail\RiderDetail.test.js", "JavaScript", -18, 0, 0, 0, 0, 0, -2, -20
"c:\Users\Administrator\Desktop\bakalauras\JourneyFy\_tests_\Component\RideDetail\RiderInfo.test.js", "JavaScript", -14, 0, 0, 0, 0, 0, -2, -16
"c:\Users\Administrator\Desktop\bakalauras\JourneyFy\_tests_\Component\RideHistory\EmptyRideList.test.js", "JavaScript", -13, 0, 0, 0, 0, -2, -2, -17
"c:\Users\Administrator\Desktop\bakalauras\JourneyFy\_tests_\Component\RideHistory\RideHistoryItem.test.js", "JavaScript", -27, 0, 0, 0, 0, -3, -6, -36
"c:\Users\Administrator\Desktop\bakalauras\JourneyFy\_tests_\Component\RideHistory\RideHistoryList.test.js", "JavaScript", -16, 0, 0, 0, 0, -1, -3, -20
"c:\Users\Administrator\Desktop\bakalauras\JourneyFy\_tests_\Component\RideHistory\RidesHeader.test.js", "JavaScript", -12, 0, 0, 0, 0, -2, -4, -18
"c:\Users\Administrator\Desktop\bakalauras\JourneyFy\_tests_\Component\RideMapView\DirectionMap.test.js", "JavaScript", -29, 0, 0, 0, 0, -5, -4, -38
"c:\Users\Administrator\Desktop\bakalauras\JourneyFy\_tests_\Component\RideMapView\RideInfoSheet.test.js", "JavaScript", 1, 0, 0, 0, 0, 0, 0, 1
"c:\Users\Administrator\Desktop\bakalauras\JourneyFy\_tests_\Component\RideMapView\VerticalDashLine.test.js", "JavaScript", -16, 0, 0, 0, 0, -1, -2, -19
"c:\Users\Administrator\Desktop\bakalauras\JourneyFy\_tests_\Component\RideRequest\RequestItem.test.js", "JavaScript", -60, 0, 0, 0, 0, -6, -11, -77
"c:\Users\Administrator\Desktop\bakalauras\JourneyFy\_tests_\Component\RideRequest\RequestList.test.js", "JavaScript", -45, 0, 0, 0, 0, -3, -7, -55
"c:\Users\Administrator\Desktop\bakalauras\JourneyFy\_tests_\Component\RideRequest\RequestSheet.test.js", "JavaScript", -28, 0, 0, 0, 0, -3, -6, -37
"c:\Users\Administrator\Desktop\bakalauras\JourneyFy\_tests_\Component\Rides\NoRidesInfo.test.js", "JavaScript", -11, 0, 0, 0, 0, -2, -4, -17
"c:\Users\Administrator\Desktop\bakalauras\JourneyFy\_tests_\Component\Rides\RideItem.test.js", "JavaScript", -13, 0, 0, 0, 0, 0, 0, -13
"c:\Users\Administrator\Desktop\bakalauras\JourneyFy\_tests_\Component\Rides\RidesHeader.test.js", "JavaScript", -15, 0, 0, 0, 0, -1, -3, -19
"c:\Users\Administrator\Desktop\bakalauras\JourneyFy\_tests_\Component\Rides\RidesList.test.js", "JavaScript", -26, 0, 0, 0, 0, -3, -6, -35
"c:\Users\Administrator\Desktop\bakalauras\JourneyFy\_tests_\Component\Settings\MapSettingsModal.test.js", "JavaScript", -45, 0, 0, 0, 0, -1, -10, -56
"c:\Users\Administrator\Desktop\bakalauras\JourneyFy\_tests_\Component\Settings\PasswordModal.test.js", "JavaScript", -40, 0, 0, 0, 0, -1, -9, -50
"c:\Users\Administrator\Desktop\bakalauras\JourneyFy\_tests_\Component\Settings\ProfileSection.test.js", "JavaScript", -17, 0, 0, 0, 0, -2, -4, -23
"c:\Users\Administrator\Desktop\bakalauras\JourneyFy\_tests_\Component\StartRide\RideInfoSheet.test.js", "JavaScript", -14, 0, 0, 0, 0, -4, -1, -19
"c:\Users\Administrator\Desktop\bakalauras\JourneyFy\_tests_\Component\StartRide\StartRideButton.test.js", "JavaScript", -44, 0, 0, 0, 0, 0, -14, -58
"c:\Users\Administrator\Desktop\bakalauras\JourneyFy\_tests_\Component\StartRide\VerticalDashLine.test.js", "JavaScript", -14, 0, 0, 0, 0, 0, -2, -16
"c:\Users\Administrator\Desktop\bakalauras\JourneyFy\_tests_\Component\Transactions\TransactionItem.test.js", "JavaScript", -29, 0, 0, 0, 0, -8, 0, -37
"c:\Users\Administrator\Desktop\bakalauras\JourneyFy\_tests_\Component\Transactions\TransactionList.test.js", "JavaScript", -5, 0, 0, 0, 0, 0, -1, -6
"c:\Users\Administrator\Desktop\bakalauras\JourneyFy\_tests_\Component\UserVehicleScreen\AddVehicleButton.test.js", "JavaScript", -13, 0, 0, 0, 0, -1, -2, -16
"c:\Users\Administrator\Desktop\bakalauras\JourneyFy\_tests_\Component\UserVehicleScreen\SnackBarComponent.test.js", "JavaScript", -19, 0, 0, 0, 0, -1, -4, -24
"c:\Users\Administrator\Desktop\bakalauras\JourneyFy\_tests_\Component\UserVehicleScreen\StatusModal.test.js", "JavaScript", -10, 0, 0, 0, 0, 0, -1, -11
"c:\Users\Administrator\Desktop\bakalauras\JourneyFy\_tests_\Component\UserVehicleScreen\VehicleItem.test.js", "JavaScript", -50, 0, 0, 0, 0, -3, -5, -58
"c:\Users\Administrator\Desktop\bakalauras\JourneyFy\_tests_\Component\Wallet\BalanceInfo.test.js", "JavaScript", -32, 0, 0, 0, 0, -4, -9, -45
"c:\Users\Administrator\Desktop\bakalauras\JourneyFy\_tests_\Component\Wallet\WalletImage.test.js", "JavaScript", -18, 0, 0, 0, 0, -1, -2, -21
"c:\Users\Administrator\Desktop\bakalauras\JourneyFy\_tests_\Component\Wallet\WalletOption.test.js", "JavaScript", -50, 0, 0, 0, 0, 0, -5, -55
"c:\Users\Administrator\Desktop\bakalauras\JourneyFy\_tests_\Integration\AuthProvider.integration.test.js", "JavaScript", 44, 0, 0, 0, 0, 0, 9, 53
"c:\Users\Administrator\Desktop\bakalauras\JourneyFy\_tests_\Integration\firebaseServices.test.js", "JavaScript", -64, 0, 0, 0, 0, -5, -9, -78
"c:\Users\Administrator\Desktop\bakalauras\JourneyFy\_tests_\Integration\firebaseUserService.test.js", "JavaScript", -69, 0, 0, 0, 0, -1, -18, -88
"c:\Users\Administrator\Desktop\bakalauras\JourneyFy\_tests_\Integration\useAddVehicle.test.js", "JavaScript", 23, 0, 0, 0, 0, -1, 0, 22
"c:\Users\Administrator\Desktop\bakalauras\JourneyFy\_tests_\Integration\useCreateJourney.integration.test.js", "JavaScript", 67, 0, 0, 0, 0, 0, 16, 83
"c:\Users\Administrator\Desktop\bakalauras\JourneyFy\_tests_\Integration\useCreateJourney.test.js", "JavaScript", -60, 0, 0, 0, 0, -1, -12, -73
"c:\Users\Administrator\Desktop\bakalauras\JourneyFy\_tests_\Integration\useDeleteAccount.integration.test.js", "JavaScript", 44, 0, 0, 0, 0, 0, 10, 54
"c:\Users\Administrator\Desktop\bakalauras\JourneyFy\_tests_\Integration\useDriver.integration.test.js", "JavaScript", 43, 0, 0, 0, 0, 0, 13, 56
"c:\Users\Administrator\Desktop\bakalauras\JourneyFy\_tests_\Integration\useEditProfile.integration.test.js", "JavaScript", 38, 0, 0, 0, 0, 0, 13, 51
"c:\Users\Administrator\Desktop\bakalauras\JourneyFy\_tests_\Integration\useFetchVehicles.integration.test.js", "JavaScript", 62, 0, 0, 0, 0, 0, 23, 85
"c:\Users\Administrator\Desktop\bakalauras\JourneyFy\_tests_\Integration\useFetchVehicles.test.js", "JavaScript", -32, 0, 0, 0, 0, -1, -6, -39
"c:\Users\Administrator\Desktop\bakalauras\JourneyFy\_tests_\Integration\useFindMatchingJourneys.integration.test.js", "JavaScript", 81, 0, 0, 0, 0, 1, 25, 107
"c:\Users\Administrator\Desktop\bakalauras\JourneyFy\_tests_\Integration\useLocation.integration.test.js", "JavaScript", 38, 0, 0, 0, 0, 1, 12, 51
"c:\Users\Administrator\Desktop\bakalauras\JourneyFy\_tests_\Integration\useLocation.test.js", "JavaScript", -17, 0, 0, 0, 0, -1, -4, -22
"c:\Users\Administrator\Desktop\bakalauras\JourneyFy\_tests_\Integration\useMapSettings.integration.test.js", "JavaScript", 67, 0, 0, 0, 0, 1, 18, 86
"c:\Users\Administrator\Desktop\bakalauras\JourneyFy\_tests_\Integration\useMapSettings.test.js", "JavaScript", -43, 0, 0, 0, 0, -1, -5, -49
"c:\Users\Administrator\Desktop\bakalauras\JourneyFy\_tests_\Integration\useMessages.integration.test.js", "JavaScript", 66, 0, 0, 0, 0, 1, 13, 80
"c:\Users\Administrator\Desktop\bakalauras\JourneyFy\_tests_\Integration\usePasswordChange.integration.test.js", "JavaScript", 110, 0, 0, 0, 0, 1, 28, 139
"c:\Users\Administrator\Desktop\bakalauras\JourneyFy\_tests_\Integration\usePasswordChange.test.js", "JavaScript", -42, 0, 0, 0, 0, -1, -7, -50
"c:\Users\Administrator\Desktop\bakalauras\JourneyFy\_tests_\Integration\useRegistration.integration.test.js", "JavaScript", 92, 0, 0, 0, 0, 0, 23, 115
"c:\Users\Administrator\Desktop\bakalauras\JourneyFy\_tests_\Integration\useRegistration.test.js", "JavaScript", -39, 0, 0, 0, 0, -1, -6, -46
"c:\Users\Administrator\Desktop\bakalauras\JourneyFy\_tests_\Integration\useRideAndDriver.integration.test.js", "JavaScript", 52, 0, 0, 0, 0, 0, 11, 63
"c:\Users\Administrator\Desktop\bakalauras\JourneyFy\_tests_\Integration\useRideAndDriver.test.js", "JavaScript", -21, 0, 0, 0, 0, -1, -4, -26
"c:\Users\Administrator\Desktop\bakalauras\JourneyFy\_tests_\Integration\useUpdateWalletValue.integration.test.js", "JavaScript", 56, 0, 0, 0, 0, 0, 18, 74
"c:\Users\Administrator\Desktop\bakalauras\JourneyFy\_tests_\Integration\useUpdateWalletValueFromAmount.integration.test.js", "JavaScript", 74, 0, 0, 0, 0, 0, 15, 89
"c:\Users\Administrator\Desktop\bakalauras\JourneyFy\_tests_\Integration\useUser.integration.test.js", "JavaScript", 35, 0, 0, 0, 0, 0, 5, 40
"c:\Users\Administrator\Desktop\bakalauras\JourneyFy\_tests_\Integration\useUserInfo.integration.test.js", "JavaScript", 98, 0, 0, 0, 0, 0, 14, 112
"c:\Users\Administrator\Desktop\bakalauras\JourneyFy\_tests_\Integration\useUserProfile.integration.test.js", "JavaScript", 76, 0, 0, 0, 0, 2, 14, 92
"c:\Users\Administrator\Desktop\bakalauras\JourneyFy\_tests_\Integration\useUserVehicles.integration.test.js", "JavaScript", 120, 0, 0, 0, 0, 0, 8, 128
"c:\Users\Administrator\Desktop\bakalauras\JourneyFy\_tests_\Integration\useWalletValue.integration.test.js", "JavaScript", 53, 0, 0, 0, 0, 0, 9, 62
"c:\Users\Administrator\Desktop\bakalauras\JourneyFy\_tests_\Unit\Authentication\ForgotPassword.test.js", "JavaScript", 17, 0, 0, 0, 0, -7, -1, 9
"c:\Users\Administrator\Desktop\bakalauras\JourneyFy\_tests_\Unit\Authentication\Login.test.js", "JavaScript", 4, 0, 0, 0, 0, -4, -3, -3
"c:\Users\Administrator\Desktop\bakalauras\JourneyFy\_tests_\Unit\Authentication\MainInfo.test.js", "JavaScript", 26, 0, 0, 0, 0, -14, 4, 16
"c:\Users\Administrator\Desktop\bakalauras\JourneyFy\_tests_\Unit\Authentication\Register.test.js", "JavaScript", 10, 0, 0, 0, 0, -7, 1, 4
"c:\Users\Administrator\Desktop\bakalauras\JourneyFy\_tests_\Unit\Journey\AddVehicleScreen.test.js", "JavaScript", 16, 0, 0, 0, 0, -18, 0, -2
"c:\Users\Administrator\Desktop\bakalauras\JourneyFy\_tests_\Unit\Journey\AvailableRidesScreen.test.js", "JavaScript", 13, 0, 0, 0, 0, -13, -3, -3
"c:\Users\Administrator\Desktop\bakalauras\JourneyFy\_tests_\Unit\Journey\ConfirmPoolingScreen.test.js", "JavaScript", -84, 0, 0, 0, 0, -22, -28, -134
"c:\Users\Administrator\Desktop\bakalauras\JourneyFy\_tests_\Unit\Journey\EndRideScreen.test.js", "JavaScript", -83, 0, 0, 0, 0, -16, -21, -120
"c:\Users\Administrator\Desktop\bakalauras\JourneyFy\_tests_\Unit\Journey\HistoryRideDetailScreen.test.js", "JavaScript", -8, 0, 0, 0, 0, -19, -20, -47
"c:\Users\Administrator\Desktop\bakalauras\JourneyFy\_tests_\Unit\Journey\MessageScreen.test.js", "JavaScript", -19, 0, 0, 0, 0, -17, -18, -54
"c:\Users\Administrator\Desktop\bakalauras\JourneyFy\_tests_\Unit\Journey\OfferRideScreen.test.js", "JavaScript", -25, 0, 0, 0, 0, -31, -23, -79
"c:\Users\Administrator\Desktop\bakalauras\JourneyFy\_tests_\Unit\Journey\OnboardingScreen.test.js", "JavaScript", 0, 0, 0, 0, 0, 0, -1, -1
"c:\Users\Administrator\Desktop\bakalauras\JourneyFy\_tests_\Unit\Journey\PickLocationScreen.test.js", "JavaScript", 9, 0, 0, 0, 0, -9, -10, -10
"c:\Users\Administrator\Desktop\bakalauras\JourneyFy\_tests_\Unit\Journey\RideCompleteScreen.test.js", "JavaScript", -55, 0, 0, 0, 0, 0, -10, -65
"c:\Users\Administrator\Desktop\bakalauras\JourneyFy\_tests_\Unit\Journey\RideDetailScreen.test.js", "JavaScript", 36, 0, 0, 0, 0, -7, 5, 34
"c:\Users\Administrator\Desktop\bakalauras\JourneyFy\_tests_\Unit\Journey\RideMapViewScreen.test.js", "JavaScript", -24, 0, 0, 0, 0, 0, -4, -28
"c:\Users\Administrator\Desktop\bakalauras\JourneyFy\_tests_\Unit\Journey\RideRequestScreen.test.js", "JavaScript", -119, 0, 0, 0, 0, -18, -17, -154
"c:\Users\Administrator\Desktop\bakalauras\JourneyFy\_tests_\Unit\Journey\StartRideScreen.test.js", "JavaScript", 11, 0, 0, 0, 0, -11, -7, -7
"c:\Users\Administrator\Desktop\bakalauras\JourneyFy\_tests_\Unit\Main\HomeScreen.test.js", "JavaScript", 46, 0, 0, 0, 0, -12, -2, 32
"c:\Users\Administrator\Desktop\bakalauras\JourneyFy\_tests_\Unit\Main\RidesScreen.test.js", "JavaScript", -47, 0, 0, 0, 0, -10, -7, -64
"c:\Users\Administrator\Desktop\bakalauras\JourneyFy\_tests_\Unit\Main\Settings.test.js", "JavaScript", 79, 0, 0, 0, 0, -17, -2, 60
"c:\Users\Administrator\Desktop\bakalauras\JourneyFy\_tests_\Unit\Main\WalletScreen.test.js", "JavaScript", 11, 0, 0, 0, 0, -6, 12, 17
"c:\Users\Administrator\Desktop\bakalauras\JourneyFy\_tests_\Unit\Profile\CustomerSupportScreen.test.js", "JavaScript", -27, 0, 0, 0, 0, 0, -6, -33
"c:\Users\Administrator\Desktop\bakalauras\JourneyFy\_tests_\Unit\Profile\EditProfileScreen.test.js", "JavaScript", 22, 0, 0, 0, 0, -4, 16, 34
"c:\Users\Administrator\Desktop\bakalauras\JourneyFy\_tests_\Unit\Profile\FaqScreen.test.js", "JavaScript", -19, 0, 0, 0, 0, -1, -5, -25
"c:\Users\Administrator\Desktop\bakalauras\JourneyFy\_tests_\Unit\Profile\PrivacyPolicyScreen.test.js", "JavaScript", -19, 0, 0, 0, 0, -1, -3, -23
"c:\Users\Administrator\Desktop\bakalauras\JourneyFy\_tests_\Unit\Profile\ProfileScreen.test.js", "JavaScript", 60, 0, 0, 0, 0, -3, 11, 68
"c:\Users\Administrator\Desktop\bakalauras\JourneyFy\_tests_\Unit\Profile\RideHistoryScreen.test.js", "JavaScript", 25, 0, 0, 0, 0, -1, 12, 36
"c:\Users\Administrator\Desktop\bakalauras\JourneyFy\_tests_\Unit\Profile\TermsAndConditionsScreen.test.js", "JavaScript", -17, 0, 0, 0, 0, -1, -4, -22
"c:\Users\Administrator\Desktop\bakalauras\JourneyFy\_tests_\Unit\Profile\UserVehiclesScreen.test.js", "JavaScript", 92, 0, 0, 0, 0, -3, 9, 98
"c:\Users\Administrator\Desktop\bakalauras\JourneyFy\_tests_\Unit\Wallet\AddAndSendMoneyScreen.test.js", "JavaScript", -63, 0, 0, 0, 0, -4, -6, -73
"c:\Users\Administrator\Desktop\bakalauras\JourneyFy\_tests_\Unit\Wallet\BankInfoScreen.test.js", "JavaScript", -33, 0, 0, 0, 0, 0, -4, -37
"c:\Users\Administrator\Desktop\bakalauras\JourneyFy\_tests_\Unit\Wallet\CreditCardScreen.test.js", "JavaScript", -28, 0, 0, 0, 0, 0, -4, -32
"c:\Users\Administrator\Desktop\bakalauras\JourneyFy\_tests_\Unit\Wallet\PaymentMethodsScreen.test.js", "JavaScript", -28, 0, 0, 0, 0, 0, -5, -33
"c:\Users\Administrator\Desktop\bakalauras\JourneyFy\_tests_\Unit\Wallet\SuccessfullyAddAndSendScreen.test.js", "JavaScript", -56, 0, 0, 0, 0, 0, -7, -63
"c:\Users\Administrator\Desktop\bakalauras\JourneyFy\_tests_\Unit\Wallet\TransactionsScreen.test.js", "JavaScript", -18, 0, 0, 0, 0, 0, -3, -21
"c:\Users\Administrator\Desktop\bakalauras\JourneyFy\coverage\lcov-report\assets\xml\index.html", "HTML", 0, 0, 0, -102, 0, 0, -14, -116
"c:\Users\Administrator\Desktop\bakalauras\JourneyFy\coverage\lcov-report\assets\xml\svg.ts.html", "HTML", 0, 0, 0, -287, 0, 0, -14, -301
"c:\Users\Administrator\Desktop\bakalauras\JourneyFy\coverage\lcov-report\base.css", "CSS", 0, 0, 0, 0, -203, -9, -13, -225
"c:\Users\Administrator\Desktop\bakalauras\JourneyFy\coverage\lcov-report\block-navigation.js", "JavaScript", -66, 0, 0, 0, 0, -7, -15, -88
"c:\Users\Administrator\Desktop\bakalauras\JourneyFy\coverage\lcov-report\components\AddAndSendMoney\AmountInfo.js.html", "HTML", 0, 0, 0, -191, 0, 0, -14, -205
"c:\Users\Administrator\Desktop\bakalauras\JourneyFy\coverage\lcov-report\components\AddAndSendMoney\ContinueButton.js.html", "HTML", 0, 0, 0, -128, 0, 0, -14, -142
"c:\Users\Administrator\Desktop\bakalauras\JourneyFy\coverage\lcov-report\components\AddAndSendMoney\WalletImage.js.html", "HTML", 0, 0, 0, -146, 0, 0, -14, -160
"c:\Users\Administrator\Desktop\bakalauras\JourneyFy\coverage\lcov-report\components\AddAndSendMoney\index.html", "HTML", 0, 0, 0, -130, 0, 0, -16, -146
"c:\Users\Administrator\Desktop\bakalauras\JourneyFy\coverage\lcov-report\components\AddVehicle\ImagePickerBottomSheet.js.html", "HTML", 0, 0, 0, -401, 0, 0, -14, -415
"c:\Users\Administrator\Desktop\bakalauras\JourneyFy\coverage\lcov-report\components\AddVehicle\VehicleForm.js.html", "HTML", 0, 0, 0, -408, 0, 0, -19, -427
"c:\Users\Administrator\Desktop\bakalauras\JourneyFy\coverage\lcov-report\components\AddVehicle\VehicleTypeSheet.js.html", "HTML", 0, 0, 0, -335, 0, 0, -14, -349
"c:\Users\Administrator\Desktop\bakalauras\JourneyFy\coverage\lcov-report\components\AddVehicle\index.html", "HTML", 0, 0, 0, -130, 0, 0, -16, -146
"c:\Users\Administrator\Desktop\bakalauras\JourneyFy\coverage\lcov-report\components\BankInfo\AccountHolderInput.js.html", "HTML", 0, 0, 0, -206, 0, 0, -14, -220
"c:\Users\Administrator\Desktop\bakalauras\JourneyFy\coverage\lcov-report\components\BankInfo\AccountNumberInput.js.html", "HTML", 0, 0, 0, -218, 0, 0, -14, -232
"c:\Users\Administrator\Desktop\bakalauras\JourneyFy\coverage\lcov-report\components\BankInfo\BankNameInput.js.html", "HTML", 0, 0, 0, -212, 0, 0, -14, -226
"c:\Users\Administrator\Desktop\bakalauras\JourneyFy\coverage\lcov-report\components\BankInfo\BranchCodeInput.js.html", "HTML", 0, 0, 0, -212, 0, 0, -14, -226
"c:\Users\Administrator\Desktop\bakalauras\JourneyFy\coverage\lcov-report\components\BankInfo\SubmitButton.js.html", "HTML", 0, 0, 0, -131, 0, 0, -14, -145
"c:\Users\Administrator\Desktop\bakalauras\JourneyFy\coverage\lcov-report\components\BankInfo\index.html", "HTML", 0, 0, 0, -158, 0, 0, -18, -176
"c:\Users\Administrator\Desktop\bakalauras\JourneyFy\coverage\lcov-report\components\CreditCard\ContinueButton.js.html", "HTML", 0, 0, 0, -149, 0, 0, -14, -163
"c:\Users\Administrator\Desktop\bakalauras\JourneyFy\coverage\lcov-report\components\CreditCard\CreditCardForm.js.html", "HTML", 0, 0, 0, -191, 0, 0, -14, -205
"c:\Users\Administrator\Desktop\bakalauras\JourneyFy\coverage\lcov-report\components\CreditCard\PaypalForm.js.html", "HTML", 0, 0, 0, -221, 0, 0, -14, -235
"c:\Users\Administrator\Desktop\bakalauras\JourneyFy\coverage\lcov-report\components\CreditCard\index.html", "HTML", 0, 0, 0, -130, 0, 0, -16, -146
"c:\Users\Administrator\Desktop\bakalauras\JourneyFy\coverage\lcov-report\components\CustomerSupport\CallAndMailButtons.js.html", "HTML", 0, 0, 0, -203, 0, 0, -14, -217
"c:\Users\Administrator\Desktop\bakalauras\JourneyFy\coverage\lcov-report\components\CustomerSupport\ContactInfo.js.html", "HTML", 0, 0, 0, -167, 0, 0, -14, -181
"c:\Users\Administrator\Desktop\bakalauras\JourneyFy\coverage\lcov-report\components\CustomerSupport\SubmitButton.js.html", "HTML", 0, 0, 0, -131, 0, 0, -14, -145
"c:\Users\Administrator\Desktop\bakalauras\JourneyFy\coverage\lcov-report\components\CustomerSupport\SupportForm.js.html", "HTML", 0, 0, 0, -305, 0, 0, -14, -319
"c:\Users\Administrator\Desktop\bakalauras\JourneyFy\coverage\lcov-report\components\CustomerSupport\index.html", "HTML", 0, 0, 0, -144, 0, 0, -17, -161
"c:\Users\Administrator\Desktop\bakalauras\JourneyFy\coverage\lcov-report\components\EndRide\EndRideButton.js.html", "HTML", 0, 0, 0, -170, 0, 0, -14, -184
"c:\Users\Administrator\Desktop\bakalauras\JourneyFy\coverage\lcov-report\components\EndRide\MapDirection.js.html", "HTML", 0, 0, 0, -230, 0, 0, -14, -244
"c:\Users\Administrator\Desktop\bakalauras\JourneyFy\coverage\lcov-report\components\EndRide\PassengerList.js.html", "HTML", 0, 0, 0, -209, 0, 0, -14, -223
"c:\Users\Administrator\Desktop\bakalauras\JourneyFy\coverage\lcov-report\components\EndRide\RideInfoSheet.js.html", "HTML", 0, 0, 0, -245, 0, 0, -14, -259
"c:\Users\Administrator\Desktop\bakalauras\JourneyFy\coverage\lcov-report\components\EndRide\RouteList.js.html", "HTML", 0, 0, 0, -302, 0, 0, -14, -316
"c:\Users\Administrator\Desktop\bakalauras\JourneyFy\coverage\lcov-report\components\EndRide\index.html", "HTML", 0, 0, 0, -158, 0, 0, -18, -176
"c:\Users\Administrator\Desktop\bakalauras\JourneyFy\coverage\lcov-report\components\Entry\EntryButton.tsx.html", "HTML", 0, 0, 0, -317, 0, 0, -14, -331
"c:\Users\Administrator\Desktop\bakalauras\JourneyFy\coverage\lcov-report\components\Entry\EntryInputField.tsx.html", "HTML", 0, 0, 0, -425, 0, 0, -14, -439
"c:\Users\Administrator\Desktop\bakalauras\JourneyFy\coverage\lcov-report\components\Entry\index.html", "HTML", 0, 0, 0, -116, 0, 0, -15, -131
"c:\Users\Administrator\Desktop\bakalauras\JourneyFy\coverage\lcov-report\components\HistoryRideDetail\RateRideButton.js.html", "HTML", 0, 0, 0, -113, 0, 0, -14, -127
"c:\Users\Administrator\Desktop\bakalauras\JourneyFy\coverage\lcov-report\components\HistoryRideDetail\RateRideDialog.js.html", "HTML", 0, 0, 0, -539, 0, 0, -14, -553
"c:\Users\Administrator\Desktop\bakalauras\JourneyFy\coverage\lcov-report\components\HistoryRideDetail\RiderDetail.js.html", "HTML", 0, 0, 0, -179, 0, 0, -14, -193
"c:\Users\Administrator\Desktop\bakalauras\JourneyFy\coverage\lcov-report\components\HistoryRideDetail\RiderInfo.js.html", "HTML", 0, 0, 0, -128, 0, 0, -14, -142
"c:\Users\Administrator\Desktop\bakalauras\JourneyFy\coverage\lcov-report\components\HistoryRideDetail\VehicleInfo.js.html", "HTML", 0, 0, 0, -152, 0, 0, -14, -166
"c:\Users\Administrator\Desktop\bakalauras\JourneyFy\coverage\lcov-report\components\HistoryRideDetail\index.html", "HTML", 0, 0, 0, -158, 0, 0, -18, -176
"c:\Users\Administrator\Desktop\bakalauras\JourneyFy\coverage\lcov-report\components\Home\DateTimePickerSheet.js.html", "HTML", 0, 0, 0, -584, 0, 0, -14, -598
"c:\Users\Administrator\Desktop\bakalauras\JourneyFy\coverage\lcov-report\components\Home\Header.js.html", "HTML", 0, 0, 0, -323, 0, 0, -14, -337
"c:\Users\Administrator\Desktop\bakalauras\JourneyFy\coverage\lcov-report\components\Home\MapComponent.js.html", "HTML", 0, 0, 0, -128, 0, 0, -14, -142
"c:\Users\Administrator\Desktop\bakalauras\JourneyFy\coverage\lcov-report\components\Home\NoOfSeatSheet.js.html", "HTML", 0, 0, 0, -272, 0, 0, -14, -286
"c:\Users\Administrator\Desktop\bakalauras\JourneyFy\coverage\lcov-report\components\Home\RideInfoCard.js.html", "HTML", 0, 0, 0, -728, 0, 0, -14, -742
"c:\Users\Administrator\Desktop\bakalauras\JourneyFy\coverage\lcov-report\components\Home\index.html", "HTML", 0, 0, 0, -158, 0, 0, -18, -176
"c:\Users\Administrator\Desktop\bakalauras\JourneyFy\coverage\lcov-report\components\LoadingIndicator.js.html", "HTML", 0, 0, 0, -98, 0, 0, -14, -112
"c:\Users\Administrator\Desktop\bakalauras\JourneyFy\coverage\lcov-report\components\Message\MessageHeader.js.html", "HTML", 0, 0, 0, -254, 0, 0, -14, -268
"c:\Users\Administrator\Desktop\bakalauras\JourneyFy\coverage\lcov-report\components\Message\MessageInput.js.html", "HTML", 0, 0, 0, -248, 0, 0, -14, -262
"c:\Users\Administrator\Desktop\bakalauras\JourneyFy\coverage\lcov-report\components\Message\MessageItem.js.html", "HTML", 0, 0, 0, -362, 0, 0, -14, -376
"c:\Users\Administrator\Desktop\bakalauras\JourneyFy\coverage\lcov-report\components\Message\MessageList.js.html", "HTML", 0, 0, 0, -146, 0, 0, -14, -160
"c:\Users\Administrator\Desktop\bakalauras\JourneyFy\coverage\lcov-report\components\Message\index.html", "HTML", 0, 0, 0, -144, 0, 0, -17, -161
"c:\Users\Administrator\Desktop\bakalauras\JourneyFy\coverage\lcov-report\components\OfferRide\CarInfo.js.html", "HTML", 0, 0, 0, -290, 0, 0, -14, -304
"c:\Users\Administrator\Desktop\bakalauras\JourneyFy\coverage\lcov-report\components\OfferRide\CarSelectionSheet.js.html", "HTML", 0, 0, 0, -260, 0, 0, -14, -274
"c:\Users\Administrator\Desktop\bakalauras\JourneyFy\coverage\lcov-report\components\OfferRide\ContinueButton.js.html", "HTML", 0, 0, 0, -131, 0, 0, -14, -145
"c:\Users\Administrator\Desktop\bakalauras\JourneyFy\coverage\lcov-report\components\OfferRide\FacilityInfo.js.html", "HTML", 0, 0, 0, -227, 0, 0, -14, -241
"c:\Users\Administrator\Desktop\bakalauras\JourneyFy\coverage\lcov-report\components\OfferRide\LocationInfo.js.html", "HTML", 0, 0, 0, -413, 0, 0, -14, -427
"c:\Users\Administrator\Desktop\bakalauras\JourneyFy\coverage\lcov-report\components\OfferRide\PriceInfo.js.html", "HTML", 0, 0, 0, -206, 0, 0, -14, -220
"c:\Users\Administrator\Desktop\bakalauras\JourneyFy\coverage\lcov-report\components\OfferRide\SeatInfo.js.html", "HTML", 0, 0, 0, -203, 0, 0, -14, -217
"c:\Users\Administrator\Desktop\bakalauras\JourneyFy\coverage\lcov-report\components\OfferRide\SeatSelectionSheet.js.html", "HTML", 0, 0, 0, -275, 0, 0, -14, -289
"c:\Users\Administrator\Desktop\bakalauras\JourneyFy\coverage\lcov-report\components\OfferRide\index.html", "HTML", 0, 0, 0, -200, 0, 0, -21, -221
"c:\Users\Administrator\Desktop\bakalauras\JourneyFy\coverage\lcov-report\components\PaymentMethods\PaymentMethodItem.js.html", "HTML", 0, 0, 0, -260, 0, 0, -14, -274
"c:\Users\Administrator\Desktop\bakalauras\JourneyFy\coverage\lcov-report\components\PaymentMethods\PaymentMethodList.js.html", "HTML", 0, 0, 0, -157, 0, 0, -15, -172
"c:\Users\Administrator\Desktop\bakalauras\JourneyFy\coverage\lcov-report\components\PaymentMethods\index.html", "HTML", 0, 0, 0, -116, 0, 0, -15, -131
"c:\Users\Administrator\Desktop\bakalauras\JourneyFy\coverage\lcov-report\components\PickLocation\LocationFooter.js.html", "HTML", 0, 0, 0, -254, 0, 0, -14, -268
"c:\Users\Administrator\Desktop\bakalauras\JourneyFy\coverage\lcov-report\components\PickLocation\LocationSearchHeader.js.html", "HTML", 0, 0, 0, -446, 0, 0, -14, -460
"c:\Users\Administrator\Desktop\bakalauras\JourneyFy\coverage\lcov-report\components\PickLocation\PickLocationMap.js.html", "HTML", 0, 0, 0, -191, 0, 0, -14, -205
"c:\Users\Administrator\Desktop\bakalauras\JourneyFy\coverage\lcov-report\components\PickLocation\index.html", "HTML", 0, 0, 0, -130, 0, 0, -16, -146
"c:\Users\Administrator\Desktop\bakalauras\JourneyFy\coverage\lcov-report\components\Profile\Divider.js.html", "HTML", 0, 0, 0, -116, 0, 0, -14, -130
"c:\Users\Administrator\Desktop\bakalauras\JourneyFy\coverage\lcov-report\components\Profile\LogoutDialog.js.html", "HTML", 0, 0, 0, -266, 0, 0, -14, -280
"c:\Users\Administrator\Desktop\bakalauras\JourneyFy\coverage\lcov-report\components\Profile\ProfileInputField.tsx.html", "HTML", 0, 0, 0, -503, 0, 0, -14, -517
"c:\Users\Administrator\Desktop\bakalauras\JourneyFy\coverage\lcov-report\components\Profile\ProfileOption.js.html", "HTML", 0, 0, 0, -179, 0, 0, -14, -193
"c:\Users\Administrator\Desktop\bakalauras\JourneyFy\coverage\lcov-report\components\Profile\ProfilePicture.js.html", "HTML", 0, 0, 0, -341, 0, 0, -14, -355
"c:\Users\Administrator\Desktop\bakalauras\JourneyFy\coverage\lcov-report\components\Profile\UpdateButton.js.html", "HTML", 0, 0, 0, -113, 0, 0, -14, -127
"c:\Users\Administrator\Desktop\bakalauras\JourneyFy\coverage\lcov-report\components\Profile\index.html", "HTML", 0, 0, 0, -172, 0, 0, -19, -191
"c:\Users\Administrator\Desktop\bakalauras\JourneyFy\coverage\lcov-report\components\RideDetail\CancelRideDialog.js.html", "HTML", 0, 0, 0, -236, 0, 0, -14, -250
"c:\Users\Administrator\Desktop\bakalauras\JourneyFy\coverage\lcov-report\components\RideDetail\PassengerDetail.js.html", "HTML", 0, 0, 0, -518, 0, 0, -14, -532
"c:\Users\Administrator\Desktop\bakalauras\JourneyFy\coverage\lcov-report\components\RideDetail\ReviewInfo.js.html", "HTML", 0, 0, 0, -305, 0, 0, -14, -319
"c:\Users\Administrator\Desktop\bakalauras\JourneyFy\coverage\lcov-report\components\RideDetail\RideDetailFooter.js.html", "HTML", 0, 0, 0, -299, 0, 0, -14, -313
"c:\Users\Administrator\Desktop\bakalauras\JourneyFy\coverage\lcov-report\components\RideDetail\RideDetailHeader.js.html", "HTML", 0, 0, 0, -119, 0, 0, -14, -133
"c:\Users\Administrator\Desktop\bakalauras\JourneyFy\coverage\lcov-report\components\RideDetail\RiderDetail.js.html", "HTML", 0, 0, 0, -329, 0, 0, -14, -343
"c:\Users\Administrator\Desktop\bakalauras\JourneyFy\coverage\lcov-report\components\RideDetail\RiderInfo.js.html", "HTML", 0, 0, 0, -176, 0, 0, -14, -190
"c:\Users\Administrator\Desktop\bakalauras\JourneyFy\coverage\lcov-report\components\RideDetail\VehicleInfo.js.html", "HTML", 0, 0, 0, -251, 0, 0, -14, -265
"c:\Users\Administrator\Desktop\bakalauras\JourneyFy\coverage\lcov-report\components\RideDetail\index.html", "HTML", 0, 0, 0, -200, 0, 0, -21, -221
"c:\Users\Administrator\Desktop\bakalauras\JourneyFy\coverage\lcov-report\components\RideHistory\EmptyRideList.js.html", "HTML", 0, 0, 0, -155, 0, 0, -14, -169
"c:\Users\Administrator\Desktop\bakalauras\JourneyFy\coverage\lcov-report\components\RideHistory\RideHistoryItem.js.html", "HTML", 0, 0, 0, -512, 0, 0, -14, -526
"c:\Users\Administrator\Desktop\bakalauras\JourneyFy\coverage\lcov-report\components\RideHistory\RideHistoryList.js.html", "HTML", 0, 0, 0, -122, 0, 0, -14, -136
"c:\Users\Administrator\Desktop\bakalauras\JourneyFy\coverage\lcov-report\components\RideHistory\RidesHeader.js.html", "HTML", 0, 0, 0, -209, 0, 0, -14, -223
"c:\Users\Administrator\Desktop\bakalauras\JourneyFy\coverage\lcov-report\components\RideHistory\index.html", "HTML", 0, 0, 0, -144, 0, 0, -17, -161
"c:\Users\Administrator\Desktop\bakalauras\JourneyFy\coverage\lcov-report\components\RideMapView\DirectionMap.js.html", "HTML", 0, 0, 0, -374, 0, 0, -14, -388
"c:\Users\Administrator\Desktop\bakalauras\JourneyFy\coverage\lcov-report\components\RideMapView\RideInfoSheet.js.html", "HTML", 0, 0, 0, -518, 0, 0, -14, -532
"c:\Users\Administrator\Desktop\bakalauras\JourneyFy\coverage\lcov-report\components\RideMapView\VerticalDashLine.js.html", "HTML", 0, 0, 0, -128, 0, 0, -14, -142
"c:\Users\Administrator\Desktop\bakalauras\JourneyFy\coverage\lcov-report\components\RideMapView\index.html", "HTML", 0, 0, 0, -130, 0, 0, -16, -146
"c:\Users\Administrator\Desktop\bakalauras\JourneyFy\coverage\lcov-report\components\RideRequest\RequestItem.js.html", "HTML", 0, 0, 0, -635, 0, 0, -14, -649
"c:\Users\Administrator\Desktop\bakalauras\JourneyFy\coverage\lcov-report\components\RideRequest\RequestList.js.html", "HTML", 0, 0, 0, -140, 0, 0, -14, -154
"c:\Users\Administrator\Desktop\bakalauras\JourneyFy\coverage\lcov-report\components\RideRequest\RequestSheet.js.html", "HTML", 0, 0, 0, -521, 0, 0, -14, -535
"c:\Users\Administrator\Desktop\bakalauras\JourneyFy\coverage\lcov-report\components\RideRequest\index.html", "HTML", 0, 0, 0, -130, 0, 0, -16, -146
"c:\Users\Administrator\Desktop\bakalauras\JourneyFy\coverage\lcov-report\components\Rides\NoRidesInfo.js.html", "HTML", 0, 0, 0, -155, 0, 0, -14, -169
"c:\Users\Administrator\Desktop\bakalauras\JourneyFy\coverage\lcov-report\components\Rides\RideItem.js.html", "HTML", 0, 0, 0, -431, 0, 0, -14, -445
"c:\Users\Administrator\Desktop\bakalauras\JourneyFy\coverage\lcov-report\components\Rides\RidesHeader.js.html", "HTML", 0, 0, 0, -233, 0, 0, -14, -247
"c:\Users\Administrator\Desktop\bakalauras\JourneyFy\coverage\lcov-report\components\Rides\RidesList.js.html", "HTML", 0, 0, 0, -128, 0, 0, -14, -142
"c:\Users\Administrator\Desktop\bakalauras\JourneyFy\coverage\lcov-report\components\Rides\index.html", "HTML", 0, 0, 0, -144, 0, 0, -17, -161
"c:\Users\Administrator\Desktop\bakalauras\JourneyFy\coverage\lcov-report\components\Settings\DeleteAccountModal.js.html", "HTML", 0, 0, 0, -296, 0, 0, -14, -310
"c:\Users\Administrator\Desktop\bakalauras\JourneyFy\coverage\lcov-report\components\Settings\MapSettingsModal.js.html", "HTML", 0, 0, 0, -347, 0, 0, -14, -361
"c:\Users\Administrator\Desktop\bakalauras\JourneyFy\coverage\lcov-report\components\Settings\OptionsList.js.html", "HTML", 0, 0, 0, -218, 0, 0, -14, -232
"c:\Users\Administrator\Desktop\bakalauras\JourneyFy\coverage\lcov-report\components\Settings\PasswordModal.js.html", "HTML", 0, 0, 0, -335, 0, 0, -14, -349
"c:\Users\Administrator\Desktop\bakalauras\JourneyFy\coverage\lcov-report\components\Settings\ProfileSection.js.html", "HTML", 0, 0, 0, -251, 0, 0, -14, -265
"c:\Users\Administrator\Desktop\bakalauras\JourneyFy\coverage\lcov-report\components\Settings\index.html", "HTML", 0, 0, 0, -158, 0, 0, -18, -176
"c:\Users\Administrator\Desktop\bakalauras\JourneyFy\coverage\lcov-report\components\StartRide\DirectionInfo.js.html", "HTML", 0, 0, 0, -200, 0, 0, -14, -214
"c:\Users\Administrator\Desktop\bakalauras\JourneyFy\coverage\lcov-report\components\StartRide\RideInfoSheet.js.html", "HTML", 0, 0, 0, -233, 0, 0, -14, -247
"c:\Users\Administrator\Desktop\bakalauras\JourneyFy\coverage\lcov-report\components\StartRide\StartRideButton.js.html", "HTML", 0, 0, 0, -170, 0, 0, -14, -184
"c:\Users\Administrator\Desktop\bakalauras\JourneyFy\coverage\lcov-report\components\StartRide\VerticalDashLine.js.html", "HTML", 0, 0, 0, -128, 0, 0, -14, -142
"c:\Users\Administrator\Desktop\bakalauras\JourneyFy\coverage\lcov-report\components\StartRide\index.html", "HTML", 0, 0, 0, -144, 0, 0, -17, -161
"c:\Users\Administrator\Desktop\bakalauras\JourneyFy\coverage\lcov-report\components\Transactions\TransactionItem.js.html", "HTML", 0, 0, 0, -251, 0, 0, -14, -265
"c:\Users\Administrator\Desktop\bakalauras\JourneyFy\coverage\lcov-report\components\Transactions\TransactionList.js.html", "HTML", 0, 0, 0, -143, 0, 0, -14, -157
"c:\Users\Administrator\Desktop\bakalauras\JourneyFy\coverage\lcov-report\components\Transactions\index.html", "HTML", 0, 0, 0, -116, 0, 0, -15, -131
"c:\Users\Administrator\Desktop\bakalauras\JourneyFy\coverage\lcov-report\components\UserVehicleScreen\AddVehicleButton.js.html", "HTML", 0, 0, 0, -170, 0, 0, -14, -184
"c:\Users\Administrator\Desktop\bakalauras\JourneyFy\coverage\lcov-report\components\UserVehicleScreen\SnackBarComponent.js.html", "HTML", 0, 0, 0, -131, 0, 0, -14, -145
"c:\Users\Administrator\Desktop\bakalauras\JourneyFy\coverage\lcov-report\components\UserVehicleScreen\StatusModal.js.html", "HTML", 0, 0, 0, -236, 0, 0, -14, -250
"c:\Users\Administrator\Desktop\bakalauras\JourneyFy\coverage\lcov-report\components\UserVehicleScreen\VehicleItem.js.html", "HTML", 0, 0, 0, -323, 0, 0, -14, -337
"c:\Users\Administrator\Desktop\bakalauras\JourneyFy\coverage\lcov-report\components\UserVehicleScreen\VehiclesList.js.html", "HTML", 0, 0, 0, -167, 0, 0, -14, -181
"c:\Users\Administrator\Desktop\bakalauras\JourneyFy\coverage\lcov-report\components\UserVehicleScreen\index.html", "HTML", 0, 0, 0, -158, 0, 0, -18, -176
"c:\Users\Administrator\Desktop\bakalauras\JourneyFy\coverage\lcov-report\components\Wallet\BalanceInfo.js.html", "HTML", 0, 0, 0, -287, 0, 0, -14, -301
"c:\Users\Administrator\Desktop\bakalauras\JourneyFy\coverage\lcov-report\components\Wallet\WalletHeader.js.html", "HTML", 0, 0, 0, -140, 0, 0, -14, -154
"c:\Users\Administrator\Desktop\bakalauras\JourneyFy\coverage\lcov-report\components\Wallet\WalletImage.js.html", "HTML", 0, 0, 0, -149, 0, 0, -14, -163
"c:\Users\Administrator\Desktop\bakalauras\JourneyFy\coverage\lcov-report\components\Wallet\WalletOption.js.html", "HTML", 0, 0, 0, -278, 0, 0, -14, -292
"c:\Users\Administrator\Desktop\bakalauras\JourneyFy\coverage\lcov-report\components\Wallet\index.html", "HTML", 0, 0, 0, -144, 0, 0, -17, -161
"c:\Users\Administrator\Desktop\bakalauras\JourneyFy\coverage\lcov-report\components\bottomTabBarScreen.js.html", "HTML", 0, 0, 0, -629, 0, 0, -14, -643
"c:\Users\Administrator\Desktop\bakalauras\JourneyFy\coverage\lcov-report\components\header.js.html", "HTML", 0, 0, 0, -182, 0, 0, -14, -196
"c:\Users\Administrator\Desktop\bakalauras\JourneyFy\coverage\lcov-report\components\index.html", "HTML", 0, 0, 0, -144, 0, 0, -17, -161
"c:\Users\Administrator\Desktop\bakalauras\JourneyFy\coverage\lcov-report\components\myStatusBar.js.html", "HTML", 0, 0, 0, -122, 0, 0, -14, -136
"c:\Users\Administrator\Desktop\bakalauras\JourneyFy\coverage\lcov-report\constants\Colors.ts.html", "HTML", 0, 0, 0, -230, 0, 0, -14, -244
"c:\Users\Administrator\Desktop\bakalauras\JourneyFy\coverage\lcov-report\constants\index.html", "HTML", 0, 0, 0, -130, 0, 0, -16, -146
"c:\Users\Administrator\Desktop\bakalauras\JourneyFy\coverage\lcov-report\constants\key.js.html", "HTML", 0, 0, 0, -89, 0, 0, -14, -103
"c:\Users\Administrator\Desktop\bakalauras\JourneyFy\coverage\lcov-report\constants\styles.js.html", "HTML", 0, 0, 0, -1055, 0, 0, -14, -1069
"c:\Users\Administrator\Desktop\bakalauras\JourneyFy\coverage\lcov-report\hooks\index.html", "HTML", 0, 0, 0, -382, 0, 0, -34, -416
"c:\Users\Administrator\Desktop\bakalauras\JourneyFy\coverage\lcov-report\hooks\useAddVehicle.js.html", "HTML", 0, 0, 0, -218, 0, 0, -14, -232
"c:\Users\Administrator\Desktop\bakalauras\JourneyFy\coverage\lcov-report\hooks\useAuth.tsx.html", "HTML", 0, 0, 0, -551, 0, 0, -14, -565
"c:\Users\Administrator\Desktop\bakalauras\JourneyFy\coverage\lcov-report\hooks\useCreateJourney.js.html", "HTML", 0, 0, 0, -314, 0, 0, -14, -328
"c:\Users\Administrator\Desktop\bakalauras\JourneyFy\coverage\lcov-report\hooks\useDeleteAccount.js.html", "HTML", 0, 0, 0, -134, 0, 0, -14, -148
"c:\Users\Administrator\Desktop\bakalauras\JourneyFy\coverage\lcov-report\hooks\useDriver.js.html", "HTML", 0, 0, 0, -164, 0, 0, -14, -178
"c:\Users\Administrator\Desktop\bakalauras\JourneyFy\coverage\lcov-report\hooks\useEditProfile.js.html", "HTML", 0, 0, 0, -377, 0, 0, -14, -391
"c:\Users\Administrator\Desktop\bakalauras\JourneyFy\coverage\lcov-report\hooks\useFetchVehicles.js.html", "HTML", 0, 0, 0, -239, 0, 0, -14, -253
"c:\Users\Administrator\Desktop\bakalauras\JourneyFy\coverage\lcov-report\hooks\useFindMatchingJourneys.js.html", "HTML", 0, 0, 0, -305, 0, 0, -14, -319
"c:\Users\Administrator\Desktop\bakalauras\JourneyFy\coverage\lcov-report\hooks\useLocation.js.html", "HTML", 0, 0, 0, -149, 0, 0, -14, -163
"c:\Users\Administrator\Desktop\bakalauras\JourneyFy\coverage\lcov-report\hooks\useMapSettings.js.html", "HTML", 0, 0, 0, -329, 0, 0, -14, -343
"c:\Users\Administrator\Desktop\bakalauras\JourneyFy\coverage\lcov-report\hooks\useMessages.js.html", "HTML", 0, 0, 0, -203, 0, 0, -14, -217
"c:\Users\Administrator\Desktop\bakalauras\JourneyFy\coverage\lcov-report\hooks\usePasswordChange.js.html", "HTML", 0, 0, 0, -185, 0, 0, -14, -199
"c:\Users\Administrator\Desktop\bakalauras\JourneyFy\coverage\lcov-report\hooks\useRegistration.js.html", "HTML", 0, 0, 0, -296, 0, 0, -14, -310
"c:\Users\Administrator\Desktop\bakalauras\JourneyFy\coverage\lcov-report\hooks\useRideAndDriver.js.html", "HTML", 0, 0, 0, -155, 0, 0, -14, -169
"c:\Users\Administrator\Desktop\bakalauras\JourneyFy\coverage\lcov-report\hooks\useUpdateWalletValue.js.html", "HTML", 0, 0, 0, -167, 0, 0, -14, -181
"c:\Users\Administrator\Desktop\bakalauras\JourneyFy\coverage\lcov-report\hooks\useUpdateWalletValueFromAmount.js.html", "HTML", 0, 0, 0, -191, 0, 0, -14, -205
"c:\Users\Administrator\Desktop\bakalauras\JourneyFy\coverage\lcov-report\hooks\useUser.tsx.html", "HTML", 0, 0, 0, -587, 0, 0, -20, -607
"c:\Users\Administrator\Desktop\bakalauras\JourneyFy\coverage\lcov-report\hooks\useUserInfo.tsx.html", "HTML", 0, 0, 0, -176, 0, 0, -14, -190
"c:\Users\Administrator\Desktop\bakalauras\JourneyFy\coverage\lcov-report\hooks\useUserProfile.js.html", "HTML", 0, 0, 0, -182, 0, 0, -14, -196
"c:\Users\Administrator\Desktop\bakalauras\JourneyFy\coverage\lcov-report\hooks\useUserVehicles.js.html", "HTML", 0, 0, 0, -314, 0, 0, -14, -328
"c:\Users\Administrator\Desktop\bakalauras\JourneyFy\coverage\lcov-report\hooks\useWalletValue.js.html", "HTML", 0, 0, 0, -179, 0, 0, -14, -193
"c:\Users\Administrator\Desktop\bakalauras\JourneyFy\coverage\lcov-report\index.html", "HTML", 0, 0, 0, -984, 0, 0, -77, -1061
"c:\Users\Administrator\Desktop\bakalauras\JourneyFy\coverage\lcov-report\navigations\AdditionalNavigation.tsx.html", "HTML", 0, 0, 0, -149, 0, 0, -14, -163
"c:\Users\Administrator\Desktop\bakalauras\JourneyFy\coverage\lcov-report\navigations\AppNavigation.tsx.html", "HTML", 0, 0, 0, -230, 0, 0, -14, -244
"c:\Users\Administrator\Desktop\bakalauras\JourneyFy\coverage\lcov-report\navigations\EntryNavigation.tsx.html", "HTML", 0, 0, 0, -149, 0, 0, -14, -163
"c:\Users\Administrator\Desktop\bakalauras\JourneyFy\coverage\lcov-report\navigations\HomeNavigation.tsx.html", "HTML", 0, 0, 0, -263, 0, 0, -14, -277
"c:\Users\Administrator\Desktop\bakalauras\JourneyFy\coverage\lcov-report\navigations\InfoNavigation.tsx.html", "HTML", 0, 0, 0, -146, 0, 0, -14, -160
"c:\Users\Administrator\Desktop\bakalauras\JourneyFy\coverage\lcov-report\navigations\JourneyNavigation.tsx.html", "HTML", 0, 0, 0, -260, 0, 0, -14, -274
"c:\Users\Administrator\Desktop\bakalauras\JourneyFy\coverage\lcov-report\navigations\MainNavigation.tsx.html", "HTML", 0, 0, 0, -332, 0, 0, -14, -346
"c:\Users\Administrator\Desktop\bakalauras\JourneyFy\coverage\lcov-report\navigations\ProfileNavigation.tsx.html", "HTML", 0, 0, 0, -332, 0, 0, -14, -346
"c:\Users\Administrator\Desktop\bakalauras\JourneyFy\coverage\lcov-report\navigations\SettingsNavigation.tsx.html", "HTML", 0, 0, 0, -137, 0, 0, -14, -151
"c:\Users\Administrator\Desktop\bakalauras\JourneyFy\coverage\lcov-report\navigations\WalletNavigation.tsx.html", "HTML", 0, 0, 0, -197, 0, 0, -14, -211
"c:\Users\Administrator\Desktop\bakalauras\JourneyFy\coverage\lcov-report\navigations\index.html", "HTML", 0, 0, 0, -242, 0, 0, -24, -266
"c:\Users\Administrator\Desktop\bakalauras\JourneyFy\coverage\lcov-report\navigations\navigation.ts.html", "HTML", 0, 0, 0, -77, 0, 0, -14, -91
"c:\Users\Administrator\Desktop\bakalauras\JourneyFy\coverage\lcov-report\prettify.css", "CSS", 0, 0, 0, 0, -1, 0, -1, -2
"c:\Users\Administrator\Desktop\bakalauras\JourneyFy\coverage\lcov-report\prettify.js", "JavaScript", -1, 0, 0, 0, 0, -2, 0, -3
"c:\Users\Administrator\Desktop\bakalauras\JourneyFy\coverage\lcov-report\screens\Entry\ForgotPassword.tsx.html", "HTML", 0, 0, 0, -572, 0, 0, -14, -586
"c:\Users\Administrator\Desktop\bakalauras\JourneyFy\coverage\lcov-report\screens\Entry\Login.tsx.html", "HTML", 0, 0, 0, -590, 0, 0, -14, -604
"c:\Users\Administrator\Desktop\bakalauras\JourneyFy\coverage\lcov-report\screens\Entry\MainInfo.tsx.html", "HTML", 0, 0, 0, -512, 0, 0, -14, -526
"c:\Users\Administrator\Desktop\bakalauras\JourneyFy\coverage\lcov-report\screens\Entry\Register.tsx.html", "HTML", 0, 0, 0, -563, 0, 0, -14, -577
"c:\Users\Administrator\Desktop\bakalauras\JourneyFy\coverage\lcov-report\screens\Entry\auth\index.html", "HTML", 0, 0, 0, -130, 0, 0, -16, -146
"c:\Users\Administrator\Desktop\bakalauras\JourneyFy\coverage\lcov-report\screens\Entry\auth\loginScreen.js.html", "HTML", 0, 0, 0, -632, 0, 0, -14, -646
"c:\Users\Administrator\Desktop\bakalauras\JourneyFy\coverage\lcov-report\screens\Entry\auth\registerScreen.js.html", "HTML", 0, 0, 0, -680, 0, 0, -14, -694
"c:\Users\Administrator\Desktop\bakalauras\JourneyFy\coverage\lcov-report\screens\Entry\auth\verificationScreen.js.html", "HTML", 0, 0, 0, -827, 0, 0, -14, -841
"c:\Users\Administrator\Desktop\bakalauras\JourneyFy\coverage\lcov-report\screens\Entry\index.html", "HTML", 0, 0, 0, -144, 0, 0, -17, -161
"c:\Users\Administrator\Desktop\bakalauras\JourneyFy\coverage\lcov-report\screens\Main\Settings.tsx.html", "HTML", 0, 0, 0, -362, 0, 0, -14, -376
"c:\Users\Administrator\Desktop\bakalauras\JourneyFy\coverage\lcov-report\screens\Main\homeScreen.js.html", "HTML", 0, 0, 0, -506, 0, 0, -14, -520
"c:\Users\Administrator\Desktop\bakalauras\JourneyFy\coverage\lcov-report\screens\Main\index.html", "HTML", 0, 0, 0, -144, 0, 0, -17, -161
"c:\Users\Administrator\Desktop\bakalauras\JourneyFy\coverage\lcov-report\screens\Main\ridesScreen.js.html", "HTML", 0, 0, 0, -461, 0, 0, -14, -475
"c:\Users\Administrator\Desktop\bakalauras\JourneyFy\coverage\lcov-report\screens\Main\walletScreen.js.html", "HTML", 0, 0, 0, -152, 0, 0, -14, -166
"c:\Users\Administrator\Desktop\bakalauras\JourneyFy\coverage\lcov-report\screens\TemplateAdditional\reviews\index.html", "HTML", 0, 0, 0, -102, 0, 0, -14, -116
"c:\Users\Administrator\Desktop\bakalauras\JourneyFy\coverage\lcov-report\screens\TemplateAdditional\reviews\reviewsScreen.js.html", "HTML", 0, 0, 0, -518, 0, 0, -14, -532
"c:\Users\Administrator\Desktop\bakalauras\JourneyFy\coverage\lcov-report\screens\TemplateInfo\notifications\index.html", "HTML", 0, 0, 0, -102, 0, 0, -14, -116
"c:\Users\Administrator\Desktop\bakalauras\JourneyFy\coverage\lcov-report\screens\TemplateInfo\notifications\notificationsScreen.js.html", "HTML", 0, 0, 0, -701, 0, 0, -14, -715
"c:\Users\Administrator\Desktop\bakalauras\JourneyFy\coverage\lcov-report\screens\TemplateJourney\addVehicle\addVehicleScreen.js.html", "HTML", 0, 0, 0, -383, 0, 0, -14, -397
"c:\Users\Administrator\Desktop\bakalauras\JourneyFy\coverage\lcov-report\screens\TemplateJourney\addVehicle\index.html", "HTML", 0, 0, 0, -102, 0, 0, -14, -116
"c:\Users\Administrator\Desktop\bakalauras\JourneyFy\coverage\lcov-report\screens\TemplateJourney\availableRides\availableRidesScreen.js.html", "HTML", 0, 0, 0, -887, 0, 0, -14, -901
"c:\Users\Administrator\Desktop\bakalauras\JourneyFy\coverage\lcov-report\screens\TemplateJourney\availableRides\index.html", "HTML", 0, 0, 0, -102, 0, 0, -14, -116
"c:\Users\Administrator\Desktop\bakalauras\JourneyFy\coverage\lcov-report\screens\TemplateJourney\confirmPooling\confirmPoolingScreen.js.html", "HTML", 0, 0, 0, -314, 0, 0, -14, -328
"c:\Users\Administrator\Desktop\bakalauras\JourneyFy\coverage\lcov-report\screens\TemplateJourney\confirmPooling\index.html", "HTML", 0, 0, 0, -102, 0, 0, -14, -116
"c:\Users\Administrator\Desktop\bakalauras\JourneyFy\coverage\lcov-report\screens\TemplateJourney\endRide\EndRideStyles.js.html", "HTML", 0, 0, 0, -197, 0, 0, -14, -211
"c:\Users\Administrator\Desktop\bakalauras\JourneyFy\coverage\lcov-report\screens\TemplateJourney\endRide\endRideScreen.js.html", "HTML", 0, 0, 0, -224, 0, 0, -14, -238
"c:\Users\Administrator\Desktop\bakalauras\JourneyFy\coverage\lcov-report\screens\TemplateJourney\endRide\index.html", "HTML", 0, 0, 0, -116, 0, 0, -15, -131
"c:\Users\Administrator\Desktop\bakalauras\JourneyFy\coverage\lcov-report\screens\TemplateJourney\historyRideDetail\historyRideDetailScreen.js.html", "HTML", 0, 0, 0, -233, 0, 0, -14, -247
"c:\Users\Administrator\Desktop\bakalauras\JourneyFy\coverage\lcov-report\screens\TemplateJourney\historyRideDetail\index.html", "HTML", 0, 0, 0, -102, 0, 0, -14, -116
"c:\Users\Administrator\Desktop\bakalauras\JourneyFy\coverage\lcov-report\screens\TemplateJourney\message\index.html", "HTML", 0, 0, 0, -102, 0, 0, -14, -116
"c:\Users\Administrator\Desktop\bakalauras\JourneyFy\coverage\lcov-report\screens\TemplateJourney\message\messageScreen.js.html", "HTML", 0, 0, 0, -239, 0, 0, -14, -253
"c:\Users\Administrator\Desktop\bakalauras\JourneyFy\coverage\lcov-report\screens\TemplateJourney\offerRide\index.html", "HTML", 0, 0, 0, -102, 0, 0, -14, -116
"c:\Users\Administrator\Desktop\bakalauras\JourneyFy\coverage\lcov-report\screens\TemplateJourney\offerRide\offerRideScreen.js.html", "HTML", 0, 0, 0, -530, 0, 0, -14, -544
"c:\Users\Administrator\Desktop\bakalauras\JourneyFy\coverage\lcov-report\screens\TemplateJourney\onboarding\index.html", "HTML", 0, 0, 0, -102, 0, 0, -14, -116
"c:\Users\Administrator\Desktop\bakalauras\JourneyFy\coverage\lcov-report\screens\TemplateJourney\onboarding\onboardingScreen.js.html", "HTML", 0, 0, 0, -992, 0, 0, -14, -1006
"c:\Users\Administrator\Desktop\bakalauras\JourneyFy\coverage\lcov-report\screens\TemplateJourney\pickLocation\index.html", "HTML", 0, 0, 0, -116, 0, 0, -15, -131
"c:\Users\Administrator\Desktop\bakalauras\JourneyFy\coverage\lcov-report\screens\TemplateJourney\pickLocation\pickLocationScreen.js.html", "HTML", 0, 0, 0, -410, 0, 0, -14, -424
"c:\Users\Administrator\Desktop\bakalauras\JourneyFy\coverage\lcov-report\screens\TemplateJourney\pickLocation\pickLocationTestScreen.js.html", "HTML", 0, 0, 0, -503, 0, 0, -14, -517
"c:\Users\Administrator\Desktop\bakalauras\JourneyFy\coverage\lcov-report\screens\TemplateJourney\rideComplete\index.html", "HTML", 0, 0, 0, -102, 0, 0, -14, -116
"c:\Users\Administrator\Desktop\bakalauras\JourneyFy\coverage\lcov-report\screens\TemplateJourney\rideComplete\rideCompleteScreen.js.html", "HTML", 0, 0, 0, -317, 0, 0, -14, -331
"c:\Users\Administrator\Desktop\bakalauras\JourneyFy\coverage\lcov-report\screens\TemplateJourney\rideDetail\index.html", "HTML", 0, 0, 0, -102, 0, 0, -14, -116
"c:\Users\Administrator\Desktop\bakalauras\JourneyFy\coverage\lcov-report\screens\TemplateJourney\rideDetail\rideDetailScreen.js.html", "HTML", 0, 0, 0, -464, 0, 0, -14, -478
"c:\Users\Administrator\Desktop\bakalauras\JourneyFy\coverage\lcov-report\screens\TemplateJourney\rideMapView\index.html", "HTML", 0, 0, 0, -102, 0, 0, -14, -116
"c:\Users\Administrator\Desktop\bakalauras\JourneyFy\coverage\lcov-report\screens\TemplateJourney\rideMapView\rideMapViewScreen.js.html", "HTML", 0, 0, 0, -137, 0, 0, -14, -151
"c:\Users\Administrator\Desktop\bakalauras\JourneyFy\coverage\lcov-report\screens\TemplateJourney\rideRequest\index.html", "HTML", 0, 0, 0, -102, 0, 0, -14, -116
"c:\Users\Administrator\Desktop\bakalauras\JourneyFy\coverage\lcov-report\screens\TemplateJourney\rideRequest\rideRequestScreen.js.html", "HTML", 0, 0, 0, -488, 0, 0, -14, -502
"c:\Users\Administrator\Desktop\bakalauras\JourneyFy\coverage\lcov-report\screens\TemplateJourney\startRide\index.html", "HTML", 0, 0, 0, -102, 0, 0, -14, -116
"c:\Users\Administrator\Desktop\bakalauras\JourneyFy\coverage\lcov-report\screens\TemplateJourney\startRide\startRideScreen.js.html", "HTML", 0, 0, 0, -299, 0, 0, -14, -313
"c:\Users\Administrator\Desktop\bakalauras\JourneyFy\coverage\lcov-report\screens\TemplateProfile\customerSupport\customerSupportScreen.js.html", "HTML", 0, 0, 0, -164, 0, 0, -14, -178
"c:\Users\Administrator\Desktop\bakalauras\JourneyFy\coverage\lcov-report\screens\TemplateProfile\customerSupport\index.html", "HTML", 0, 0, 0, -102, 0, 0, -14, -116
"c:\Users\Administrator\Desktop\bakalauras\JourneyFy\coverage\lcov-report\screens\TemplateProfile\editProfile\editProfileScreen.js.html", "HTML", 0, 0, 0, -554, 0, 0, -14, -568
"c:\Users\Administrator\Desktop\bakalauras\JourneyFy\coverage\lcov-report\screens\TemplateProfile\editProfile\index.html", "HTML", 0, 0, 0, -102, 0, 0, -14, -116
"c:\Users\Administrator\Desktop\bakalauras\JourneyFy\coverage\lcov-report\screens\TemplateProfile\faq\faqScreen.js.html", "HTML", 0, 0, 0, -341, 0, 0, -14, -355
"c:\Users\Administrator\Desktop\bakalauras\JourneyFy\coverage\lcov-report\screens\TemplateProfile\faq\index.html", "HTML", 0, 0, 0, -102, 0, 0, -14, -116
"c:\Users\Administrator\Desktop\bakalauras\JourneyFy\coverage\lcov-report\screens\TemplateProfile\privacyPolicy\index.html", "HTML", 0, 0, 0, -102, 0, 0, -14, -116
"c:\Users\Administrator\Desktop\bakalauras\JourneyFy\coverage\lcov-report\screens\TemplateProfile\privacyPolicy\privacyPolicyScreen.js.html", "HTML", 0, 0, 0, -329, 0, 0, -14, -343
"c:\Users\Administrator\Desktop\bakalauras\JourneyFy\coverage\lcov-report\screens\TemplateProfile\profile\index.html", "HTML", 0, 0, 0, -102, 0, 0, -14, -116
"c:\Users\Administrator\Desktop\bakalauras\JourneyFy\coverage\lcov-report\screens\TemplateProfile\profile\profileScreen.js.html", "HTML", 0, 0, 0, -668, 0, 0, -14, -682
"c:\Users\Administrator\Desktop\bakalauras\JourneyFy\coverage\lcov-report\screens\TemplateProfile\rideHistory\index.html", "HTML", 0, 0, 0, -102, 0, 0, -14, -116
"c:\Users\Administrator\Desktop\bakalauras\JourneyFy\coverage\lcov-report\screens\TemplateProfile\rideHistory\rideHistoryScreen.js.html", "HTML", 0, 0, 0, -479, 0, 0, -14, -493
"c:\Users\Administrator\Desktop\bakalauras\JourneyFy\coverage\lcov-report\screens\TemplateProfile\termsAndConditions\index.html", "HTML", 0, 0, 0, -102, 0, 0, -14, -116
"c:\Users\Administrator\Desktop\bakalauras\JourneyFy\coverage\lcov-report\screens\TemplateProfile\termsAndConditions\termsAndConditionsScreen.js.html", "HTML", 0, 0, 0, -227, 0, 0, -14, -241
"c:\Users\Administrator\Desktop\bakalauras\JourneyFy\coverage\lcov-report\screens\TemplateProfile\userVehicles\index.html", "HTML", 0, 0, 0, -102, 0, 0, -14, -116
"c:\Users\Administrator\Desktop\bakalauras\JourneyFy\coverage\lcov-report\screens\TemplateProfile\userVehicles\userVehiclesScreen.js.html", "HTML", 0, 0, 0, -206, 0, 0, -14, -220
"c:\Users\Administrator\Desktop\bakalauras\JourneyFy\coverage\lcov-report\screens\TemplateWallet\addAndSendMoney\addAndSendMoneyScreen.js.html", "HTML", 0, 0, 0, -221, 0, 0, -14, -235
"c:\Users\Administrator\Desktop\bakalauras\JourneyFy\coverage\lcov-report\screens\TemplateWallet\addAndSendMoney\index.html", "HTML", 0, 0, 0, -102, 0, 0, -14, -116
"c:\Users\Administrator\Desktop\bakalauras\JourneyFy\coverage\lcov-report\screens\TemplateWallet\bankInfo\bankInfoScreen.js.html", "HTML", 0, 0, 0, -200, 0, 0, -14, -214
"c:\Users\Administrator\Desktop\bakalauras\JourneyFy\coverage\lcov-report\screens\TemplateWallet\bankInfo\index.html", "HTML", 0, 0, 0, -102, 0, 0, -14, -116
"c:\Users\Administrator\Desktop\bakalauras\JourneyFy\coverage\lcov-report\screens\TemplateWallet\creditCard\creditCardScreen.js.html", "HTML", 0, 0, 0, -218, 0, 0, -14, -232
"c:\Users\Administrator\Desktop\bakalauras\JourneyFy\coverage\lcov-report\screens\TemplateWallet\creditCard\index.html", "HTML", 0, 0, 0, -102, 0, 0, -14, -116
"c:\Users\Administrator\Desktop\bakalauras\JourneyFy\coverage\lcov-report\screens\TemplateWallet\paymentMethods\index.html", "HTML", 0, 0, 0, -102, 0, 0, -14, -116
"c:\Users\Administrator\Desktop\bakalauras\JourneyFy\coverage\lcov-report\screens\TemplateWallet\paymentMethods\paymentMethodsScreen.js.html", "HTML", 0, 0, 0, -267, 0, 0, -16, -283
"c:\Users\Administrator\Desktop\bakalauras\JourneyFy\coverage\lcov-report\screens\TemplateWallet\successfullyAddAndSend\index.html", "HTML", 0, 0, 0, -102, 0, 0, -14, -116
"c:\Users\Administrator\Desktop\bakalauras\JourneyFy\coverage\lcov-report\screens\TemplateWallet\successfullyAddAndSend\successfullyAddAndSendScreen.js.html", "HTML", 0, 0, 0, -407, 0, 0, -14, -421
"c:\Users\Administrator\Desktop\bakalauras\JourneyFy\coverage\lcov-report\screens\TemplateWallet\transactions\index.html", "HTML", 0, 0, 0, -102, 0, 0, -14, -116
"c:\Users\Administrator\Desktop\bakalauras\JourneyFy\coverage\lcov-report\screens\TemplateWallet\transactions\transactionsScreen.js.html", "HTML", 0, 0, 0, -392, 0, 0, -14, -406
"c:\Users\Administrator\Desktop\bakalauras\JourneyFy\coverage\lcov-report\services\firebase.tsx.html", "HTML", 0, 0, 0, -185, 0, 0, -14, -199
"c:\Users\Administrator\Desktop\bakalauras\JourneyFy\coverage\lcov-report\services\firebaseUserService.js.html", "HTML", 0, 0, 0, -200, 0, 0, -14, -214
"c:\Users\Administrator\Desktop\bakalauras\JourneyFy\coverage\lcov-report\services\index.html", "HTML", 0, 0, 0, -116, 0, 0, -15, -131
"c:\Users\Administrator\Desktop\bakalauras\JourneyFy\coverage\lcov-report\sorter.js", "JavaScript", -165, 0, 0, 0, 0, -17, -15, -197
"c:\Users\Administrator\Desktop\bakalauras\JourneyFy\coverage\lcov-report\utils\formatTime.js.html", "HTML", 0, 0, 0, -95, 0, 0, -14, -109
"c:\Users\Administrator\Desktop\bakalauras\JourneyFy\coverage\lcov-report\utils\index.html", "HTML", 0, 0, 0, -144, 0, 0, -17, -161
"c:\Users\Administrator\Desktop\bakalauras\JourneyFy\coverage\lcov-report\utils\range.js.html", "HTML", 0, 0, 0, -74, 0, 0, -14, -88
"c:\Users\Administrator\Desktop\bakalauras\JourneyFy\coverage\lcov-report\utils\uploadImage.js.html", "HTML", 0, 0, 0, -113, 0, 0, -14, -127
"c:\Users\Administrator\Desktop\bakalauras\JourneyFy\coverage\lcov-report\utils\validation.js.html", "HTML", 0, 0, 0, -129, 0, 0, -16, -145
"c:\Users\Administrator\Desktop\bakalauras\JourneyFy\jest.config.js", "JavaScript", 0, 0, 0, 0, 0, 0, -1, -1
"c:\Users\Administrator\Desktop\bakalauras\JourneyFy\src\components\AddAndSendMoney\AmountInfo.js", "JavaScript", 5, 0, 0, 0, 0, -1, 1, 5
"c:\Users\Administrator\Desktop\bakalauras\JourneyFy\src\components\AddAndSendMoney\ContinueButton.js", "JavaScript", 0, 0, 0, 0, 0, -1, 1, 0
"c:\Users\Administrator\Desktop\bakalauras\JourneyFy\src\components\AddAndSendMoney\WalletImage.js", "JavaScript", 0, 0, 0, 0, 0, -1, 0, -1
"c:\Users\Administrator\Desktop\bakalauras\JourneyFy\src\components\AddVehicle\ImagePickerBottomSheet.js", "JavaScript", 11, 0, 0, 0, 0, 0, 1, 12
"c:\Users\Administrator\Desktop\bakalauras\JourneyFy\src\components\AddVehicle\VehicleForm.js", "JavaScript", 41, 0, 0, 0, 0, 0, 1, 42
"c:\Users\Administrator\Desktop\bakalauras\JourneyFy\src\components\AddVehicle\VehicleTypeSheet.js", "JavaScript", 11, 0, 0, 0, 0, 0, -1, 10
"c:\Users\Administrator\Desktop\bakalauras\JourneyFy\src\components\CreditCard\PaypalForm.js", "JavaScript", 0, 0, 0, 0, 0, 0, 1, 1
"c:\Users\Administrator\Desktop\bakalauras\JourneyFy\src\components\CustomerSupport\SupportForm.js", "JavaScript", 15, 0, 0, 0, 0, 0, 0, 15
"c:\Users\Administrator\Desktop\bakalauras\JourneyFy\src\components\EndRide\EndRideButton.js", "JavaScript", 0, 0, 0, 0, 0, -1, 1, 0
"c:\Users\Administrator\Desktop\bakalauras\JourneyFy\src\components\EndRide\MapDirection.js", "JavaScript", -3, 0, 0, 0, 0, -1, 1, -3
"c:\Users\Administrator\Desktop\bakalauras\JourneyFy\src\components\EndRide\PassengerList.js", "JavaScript", 0, 0, 0, 0, 0, -1, 1, 0
"c:\Users\Administrator\Desktop\bakalauras\JourneyFy\src\components\EndRide\RideInfoSheet.js", "JavaScript", 4, 0, 0, 0, 0, -1, 1, 4
"c:\Users\Administrator\Desktop\bakalauras\JourneyFy\src\components\EndRide\RouteList.js", "JavaScript", 3, 0, 0, 0, 0, -1, 1, 3
"c:\Users\Administrator\Desktop\bakalauras\JourneyFy\src\components\Entry\EntryInputField.tsx", "TypeScript JSX", 0, 5, 0, 0, 0, 0, 1, 6
"c:\Users\Administrator\Desktop\bakalauras\JourneyFy\src\components\HistoryRideDetail\RateRideButton.js", "JavaScript", 0, 0, 0, 0, 0, 0, 1, 1
"c:\Users\Administrator\Desktop\bakalauras\JourneyFy\src\components\HistoryRideDetail\RateRideDialog.js", "JavaScript", -5, 0, 0, 0, 0, -3, -1, -9
"c:\Users\Administrator\Desktop\bakalauras\JourneyFy\src\components\HistoryRideDetail\RiderDetail.js", "JavaScript", 20, 0, 0, 0, 0, 0, 1, 21
"c:\Users\Administrator\Desktop\bakalauras\JourneyFy\src\components\HistoryRideDetail\RiderInfo.js", "JavaScript", 4, 0, 0, 0, 0, 0, 1, 5
"c:\Users\Administrator\Desktop\bakalauras\JourneyFy\src\components\HistoryRideDetail\VehicleInfo.js", "JavaScript", 6, 0, 0, 0, 0, 0, 1, 7
"c:\Users\Administrator\Desktop\bakalauras\JourneyFy\src\components\Home\DateTimePickerSheet.js", "JavaScript", 52, 0, 0, 0, 0, -1, 1, 52
"c:\Users\Administrator\Desktop\bakalauras\JourneyFy\src\components\Home\Header.js", "JavaScript", 4, 0, 0, 0, 0, 0, 0, 4
"c:\Users\Administrator\Desktop\bakalauras\JourneyFy\src\components\Home\NoOfSeatSheet.js", "JavaScript", 5, 0, 0, 0, 0, 0, -1, 4
"c:\Users\Administrator\Desktop\bakalauras\JourneyFy\src\components\Home\RideInfoCard.js", "JavaScript", 88, 0, 0, 0, 0, 0, 0, 88
"c:\Users\Administrator\Desktop\bakalauras\JourneyFy\src\components\Message\MessageHeader.js", "JavaScript", -2, 0, 0, 0, 0, 0, 1, -1
"c:\Users\Administrator\Desktop\bakalauras\JourneyFy\src\components\Message\MessageInput.js", "JavaScript", 4, 0, 0, 0, 0, 0, 1, 5
"c:\Users\Administrator\Desktop\bakalauras\JourneyFy\src\components\Message\MessageItem.js", "JavaScript", 8, 0, 0, 0, 0, -1, 1, 8
"c:\Users\Administrator\Desktop\bakalauras\JourneyFy\src\components\Message\MessageList.js", "JavaScript", -2, 0, 0, 0, 0, -1, 1, -2
"c:\Users\Administrator\Desktop\bakalauras\JourneyFy\src\components\OfferRide\CarInfo.js", "JavaScript", -1, 0, 0, 0, 0, -7, 0, -8
"c:\Users\Administrator\Desktop\bakalauras\JourneyFy\src\components\OfferRide\CarSelectionSheet.js", "JavaScript", 0, 0, 0, 0, 0, -1, 0, -1
"c:\Users\Administrator\Desktop\bakalauras\JourneyFy\src\components\OfferRide\ContinueButton.js", "JavaScript", 3, 0, 0, 0, 0, -1, 0, 2
"c:\Users\Administrator\Desktop\bakalauras\JourneyFy\src\components\OfferRide\FacilityInfo.js", "JavaScript", 0, 0, 0, 0, 0, -1, 1, 0
"c:\Users\Administrator\Desktop\bakalauras\JourneyFy\src\components\OfferRide\LocationInfo.js", "JavaScript", 0, 0, 0, 0, 0, -4, 1, -3
"c:\Users\Administrator\Desktop\bakalauras\JourneyFy\src\components\OfferRide\PriceInfo.js", "JavaScript", 0, 0, 0, 0, 0, 0, 1, 1
"c:\Users\Administrator\Desktop\bakalauras\JourneyFy\src\components\OfferRide\SeatInfo.js", "JavaScript", 5, 0, 0, 0, 0, -1, 0, 4
"c:\Users\Administrator\Desktop\bakalauras\JourneyFy\src\components\OfferRide\SeatSelectionSheet.js", "JavaScript", 6, 0, 0, 0, 0, -1, 0, 5
"c:\Users\Administrator\Desktop\bakalauras\JourneyFy\src\components\PaymentMethods\PaymentMethodItem.js", "JavaScript", 4, 0, 0, 0, 0, -1, 0, 3
"c:\Users\Administrator\Desktop\bakalauras\JourneyFy\src\components\PaymentMethods\PaymentMethodList.js", "JavaScript", 5, 0, 0, 0, 0, -1, 0, 4
"c:\Users\Administrator\Desktop\bakalauras\JourneyFy\src\components\PickLocation\LocationFooter.js", "JavaScript", 13, 0, 0, 0, 0, -1, 0, 12
"c:\Users\Administrator\Desktop\bakalauras\JourneyFy\src\components\PickLocation\LocationSearchHeader.js", "JavaScript", 5, 0, 0, 0, 0, -1, 1, 5
"c:\Users\Administrator\Desktop\bakalauras\JourneyFy\src\components\PickLocation\PickLocationMap.js", "JavaScript", 5, 0, 0, 0, 0, -1, 0, 4
"c:\Users\Administrator\Desktop\bakalauras\JourneyFy\src\components\Profile\LogoutDialog.js", "JavaScript", 0, 0, 0, 0, 0, 0, -1, -1
"c:\Users\Administrator\Desktop\bakalauras\JourneyFy\src\components\Profile\ProfilePicture.js", "JavaScript", 22, 0, 0, 0, 0, 0, 1, 23
"c:\Users\Administrator\Desktop\bakalauras\JourneyFy\src\components\RideDetail\CancelRideDialog.js", "JavaScript", 7, 0, 0, 0, 0, 0, 1, 8
"c:\Users\Administrator\Desktop\bakalauras\JourneyFy\src\components\RideDetail\PassengerDetail.js", "JavaScript", -7, 0, 0, 0, 0, -3, 0, -10
"c:\Users\Administrator\Desktop\bakalauras\JourneyFy\src\components\RideDetail\ReviewInfo.js", "JavaScript", 29, 0, 0, 0, 0, -1, 0, 28
"c:\Users\Administrator\Desktop\bakalauras\JourneyFy\src\components\RideDetail\RideDetailFooter.js", "JavaScript", 18, 0, 0, 0, 0, -1, 0, 17
"c:\Users\Administrator\Desktop\bakalauras\JourneyFy\src\components\RideDetail\RideDetailHeader.js", "JavaScript", 0, 0, 0, 0, 0, -1, 1, 0
"c:\Users\Administrator\Desktop\bakalauras\JourneyFy\src\components\RideDetail\RiderDetail.js", "JavaScript", 64, 0, 0, 0, 0, -19, 0, 45
"c:\Users\Administrator\Desktop\bakalauras\JourneyFy\src\components\RideDetail\RiderInfo.js", "JavaScript", 74, 0, 0, 0, 0, -1, 6, 79
"c:\Users\Administrator\Desktop\bakalauras\JourneyFy\src\components\RideDetail\VehicleInfo.js", "JavaScript", 0, 0, 0, 0, 0, -1, 1, 0
"c:\Users\Administrator\Desktop\bakalauras\JourneyFy\src\components\RideHistory\EmptyRideList.js", "JavaScript", 2, 0, 0, 0, 0, -1, 1, 2
"c:\Users\Administrator\Desktop\bakalauras\JourneyFy\src\components\RideHistory\RideHistoryItem.js", "JavaScript", -3, 0, 0, 0, 0, 0, -1, -4
"c:\Users\Administrator\Desktop\bakalauras\JourneyFy\src\components\RideHistory\RideHistoryList.js", "JavaScript", 0, 0, 0, 0, 0, 0, 1, 1
"c:\Users\Administrator\Desktop\bakalauras\JourneyFy\src\components\RideHistory\RidesHeader.js", "JavaScript", 13, 0, 0, 0, 0, -1, 1, 13
"c:\Users\Administrator\Desktop\bakalauras\JourneyFy\src\components\RideMapView\DirectionMap.js", "JavaScript", 22, 0, 0, 0, 0, -1, 0, 21
"c:\Users\Administrator\Desktop\bakalauras\JourneyFy\src\components\RideMapView\RideInfoSheet.js", "JavaScript", 56, 0, 0, 0, 0, -1, -3, 52
"c:\Users\Administrator\Desktop\bakalauras\JourneyFy\src\components\RideMapView\VerticalDashLine.js", "JavaScript", 0, 0, 0, 0, 0, -1, 0, -1
"c:\Users\Administrator\Desktop\bakalauras\JourneyFy\src\components\RideRequest\RequestItem.js", "JavaScript", -10, 0, 0, 0, 0, 0, 1, -9
"c:\Users\Administrator\Desktop\bakalauras\JourneyFy\src\components\RideRequest\RequestList.js", "JavaScript", 0, 0, 0, 0, 0, 0, 1, 1
"c:\Users\Administrator\Desktop\bakalauras\JourneyFy\src\components\RideRequest\RequestSheet.js", "JavaScript", 9, 0, 0, 0, 0, -3, 2, 8
"c:\Users\Administrator\Desktop\bakalauras\JourneyFy\src\components\Rides\NoRidesInfo.js", "JavaScript", 2, 0, 0, 0, 0, -1, 1, 2
"c:\Users\Administrator\Desktop\bakalauras\JourneyFy\src\components\Rides\RideItem.js", "JavaScript", 28, 0, 0, 0, 0, -2, 1, 27
"c:\Users\Administrator\Desktop\bakalauras\JourneyFy\src\components\Rides\RidesHeader.js", "JavaScript", 0, 0, 0, 0, 0, -1, 0, -1
"c:\Users\Administrator\Desktop\bakalauras\JourneyFy\src\components\Rides\RidesList.js", "JavaScript", 2, 0, 0, 0, 0, -1, 1, 2
"c:\Users\Administrator\Desktop\bakalauras\JourneyFy\src\components\Settings\DeleteAccountModal.js", "JavaScript", 3, 0, 0, 0, 0, 0, 0, 3
"c:\Users\Administrator\Desktop\bakalauras\JourneyFy\src\components\Settings\MapSettingsModal.js", "JavaScript", 5, 0, 0, 0, 0, 0, 0, 5
"c:\Users\Administrator\Desktop\bakalauras\JourneyFy\src\components\Settings\OptionsList.js", "JavaScript", 24, 0, 0, 0, 0, 0, 0, 24
"c:\Users\Administrator\Desktop\bakalauras\JourneyFy\src\components\Settings\PasswordModal.js", "JavaScript", 3, 0, 0, 0, 0, 0, 0, 3
"c:\Users\Administrator\Desktop\bakalauras\JourneyFy\src\components\Settings\ProfileSection.js", "JavaScript", 0, 0, 0, 0, 0, -2, 0, -2
"c:\Users\Administrator\Desktop\bakalauras\JourneyFy\src\components\StartRide\DirectionInfo.js", "JavaScript", 0, 0, 0, 0, 0, -1, 0, -1
"c:\Users\Administrator\Desktop\bakalauras\JourneyFy\src\components\StartRide\RideInfoSheet.js", "JavaScript", 2, 0, 0, 0, 0, 0, 1, 3
"c:\Users\Administrator\Desktop\bakalauras\JourneyFy\src\components\StartRide\StartRideButton.js", "JavaScript", 0, 0, 0, 0, 0, -1, 1, 0
"c:\Users\Administrator\Desktop\bakalauras\JourneyFy\src\components\StartRide\VerticalDashLine.js", "JavaScript", 0, 0, 0, 0, 0, -1, 0, -1
"c:\Users\Administrator\Desktop\bakalauras\JourneyFy\src\components\Transactions\TransactionItem.js", "JavaScript", 0, 0, 0, 0, 0, -1, 0, -1
"c:\Users\Administrator\Desktop\bakalauras\JourneyFy\src\components\Transactions\TransactionList.js", "JavaScript", 0, 0, 0, 0, 0, -1, 0, -1
"c:\Users\Administrator\Desktop\bakalauras\JourneyFy\src\components\UserVehicleScreen\StatusModal.js", "JavaScript", 3, 0, 0, 0, 0, 0, 0, 3
"c:\Users\Administrator\Desktop\bakalauras\JourneyFy\src\components\UserVehicleScreen\VehicleItem.js", "JavaScript", 13, 0, 0, 0, 0, 0, 0, 13
"c:\Users\Administrator\Desktop\bakalauras\JourneyFy\src\components\Wallet\BalanceInfo.js", "JavaScript", -2, 0, 0, 0, 0, -7, 0, -9
"c:\Users\Administrator\Desktop\bakalauras\JourneyFy\src\components\Wallet\WalletHeader.js", "JavaScript", 0, 0, 0, 0, 0, -1, 0, -1
"c:\Users\Administrator\Desktop\bakalauras\JourneyFy\src\components\Wallet\WalletImage.js", "JavaScript", 0, 0, 0, 0, 0, -1, 0, -1
"c:\Users\Administrator\Desktop\bakalauras\JourneyFy\src\components\Wallet\WalletOption.js", "JavaScript", 9, 0, 0, 0, 0, -2, 0, 7
"c:\Users\Administrator\Desktop\bakalauras\JourneyFy\src\hooks\useAddVehicle.js", "JavaScript", 7, 0, 0, 0, 0, 0, -1, 6
"c:\Users\Administrator\Desktop\bakalauras\JourneyFy\src\hooks\useCreateJourney.js", "JavaScript", 2, 0, 0, 0, 0, 0, 1, 3
"c:\Users\Administrator\Desktop\bakalauras\JourneyFy\src\hooks\useDriver.js", "JavaScript", 0, 0, 0, 0, 0, -1, 0, -1
"c:\Users\Administrator\Desktop\bakalauras\JourneyFy\src\hooks\useFetchVehicles.js", "JavaScript", 3, 0, 0, 0, 0, -7, 1, -3
"c:\Users\Administrator\Desktop\bakalauras\JourneyFy\src\hooks\useLocation.js", "JavaScript", 0, 0, 0, 0, 0, -3, 0, -3
"c:\Users\Administrator\Desktop\bakalauras\JourneyFy\src\hooks\useMapSettings.js", "JavaScript", 9, 0, 0, 0, 0, -2, 0, 7
"c:\Users\Administrator\Desktop\bakalauras\JourneyFy\src\hooks\useMessages.js", "JavaScript", -5, 0, 0, 0, 0, 0, 0, -5
"c:\Users\Administrator\Desktop\bakalauras\JourneyFy\src\hooks\usePasswordChange.js", "JavaScript", 11, 0, 0, 0, 0, 0, 0, 11
"c:\Users\Administrator\Desktop\bakalauras\JourneyFy\src\hooks\useRegistration.js", "JavaScript", 6, 0, 0, 0, 0, 0, 1, 7
"c:\Users\Administrator\Desktop\bakalauras\JourneyFy\src\hooks\useRideAndDriver.js", "JavaScript", 2, 0, 0, 0, 0, 0, 0, 2
"c:\Users\Administrator\Desktop\bakalauras\JourneyFy\src\hooks\useUpdateWalletValue.js", "JavaScript", 0, 0, 0, 0, 0, -1, 0, -1
"c:\Users\Administrator\Desktop\bakalauras\JourneyFy\src\hooks\useUpdateWalletValueFromAmount.js", "JavaScript", 1, 0, 0, 0, 0, -1, 1, 1
"c:\Users\Administrator\Desktop\bakalauras\JourneyFy\src\hooks\useUser.tsx", "TypeScript JSX", 0, 0, 0, 0, 0, -1, -2, -3
"c:\Users\Administrator\Desktop\bakalauras\JourneyFy\src\hooks\useUserVehicles.js", "JavaScript", 2, 0, 0, 0, 0, 0, 0, 2
"c:\Users\Administrator\Desktop\bakalauras\JourneyFy\src\hooks\useWalletValue.js", "JavaScript", 0, 0, 0, 0, 0, -1, 1, 0
"c:\Users\Administrator\Desktop\bakalauras\JourneyFy\src\screens\Entry\ForgotPassword.tsx", "TypeScript JSX", 0, 3, 0, 0, 0, 0, 0, 3
"c:\Users\Administrator\Desktop\bakalauras\JourneyFy\src\screens\Main\Settings.tsx", "TypeScript JSX", 0, 6, 0, 0, 0, 0, 0, 6
"c:\Users\Administrator\Desktop\bakalauras\JourneyFy\src\screens\Main\homeScreen.js", "JavaScript", -7, 0, 0, 0, 0, 0, 4, -3
"c:\Users\Administrator\Desktop\bakalauras\JourneyFy\src\screens\Main\ridesScreen.js", "JavaScript", 7, 0, 0, 0, 0, -6, 5, 6
"c:\Users\Administrator\Desktop\bakalauras\JourneyFy\src\screens\TemplateJourney\addVehicle\addVehicleScreen.js", "JavaScript", 10, 0, 0, 0, 0, 0, 1, 11
"c:\Users\Administrator\Desktop\bakalauras\JourneyFy\src\screens\TemplateJourney\availableRides\availableRidesScreen.js", "JavaScript", -2, 0, 0, 0, 0, 0, 0, -2
"c:\Users\Administrator\Desktop\bakalauras\JourneyFy\src\screens\TemplateJourney\endRide\endRideScreen.js", "JavaScript", 0, 0, 0, 0, 0, -1, 1, 0
"c:\Users\Administrator\Desktop\bakalauras\JourneyFy\src\screens\TemplateJourney\historyRideDetail\historyRideDetailScreen.js", "JavaScript", 0, 0, 0, 0, 0, -1, 1, 0
"c:\Users\Administrator\Desktop\bakalauras\JourneyFy\src\screens\TemplateJourney\message\messageScreen.js", "JavaScript", -6, 0, 0, 0, 0, 0, 1, -5
"c:\Users\Administrator\Desktop\bakalauras\JourneyFy\src\screens\TemplateJourney\offerRide\offerRideScreen.js", "JavaScript", -3, 0, 0, 0, 0, -5, 4, -4
"c:\Users\Administrator\Desktop\bakalauras\JourneyFy\src\screens\TemplateJourney\pickLocation\pickLocationScreen.js", "JavaScript", 0, 0, 0, 0, 0, -6, 1, -5
"c:\Users\Administrator\Desktop\bakalauras\JourneyFy\src\screens\TemplateJourney\rideComplete\rideCompleteScreen.js", "JavaScript", -4, 0, 0, 0, 0, 0, 0, -4
"c:\Users\Administrator\Desktop\bakalauras\JourneyFy\src\screens\TemplateJourney\rideDetail\rideDetailScreen.js", "JavaScript", 38, 0, 0, 0, 0, -4, 5, 39
"c:\Users\Administrator\Desktop\bakalauras\JourneyFy\src\screens\TemplateJourney\rideMapView\rideMapViewScreen.js", "JavaScript", 0, 0, 0, 0, 0, -1, 1, 0
"c:\Users\Administrator\Desktop\bakalauras\JourneyFy\src\screens\TemplateJourney\rideRequest\rideRequestScreen.js", "JavaScript", 28, 0, 0, 0, 0, -2, 8, 34
"c:\Users\Administrator\Desktop\bakalauras\JourneyFy\src\screens\TemplateJourney\startRide\startRideScreen.js", "JavaScript", 35, 0, 0, 0, 0, -1, 4, 38
"c:\Users\Administrator\Desktop\bakalauras\JourneyFy\src\screens\TemplateProfile\customerSupport\customerSupportScreen.js", "JavaScript", 0, 0, 0, 0, 0, -1, 1, 0
"c:\Users\Administrator\Desktop\bakalauras\JourneyFy\src\screens\TemplateProfile\editProfile\editProfileScreen.js", "JavaScript", 4, 0, 0, 0, 0, -2, 1, 3
"c:\Users\Administrator\Desktop\bakalauras\JourneyFy\src\screens\TemplateProfile\rideHistory\rideHistoryScreen.js", "JavaScript", 22, 0, 0, 0, 0, -6, 1, 17
"c:\Users\Administrator\Desktop\bakalauras\JourneyFy\src\screens\TemplateProfile\userVehicles\userVehiclesScreen.js", "JavaScript", 3, 0, 0, 0, 0, 0, 1, 4
"c:\Users\Administrator\Desktop\bakalauras\JourneyFy\src\screens\TemplateWallet\addAndSendMoney\addAndSendMoneyScreen.js", "JavaScript", 0, 0, 0, 0, 0, -1, 1, 0
"c:\Users\Administrator\Desktop\bakalauras\JourneyFy\src\screens\TemplateWallet\bankInfo\bankInfoScreen.js", "JavaScript", 2, 0, 0, 0, 0, -1, 1, 2
"c:\Users\Administrator\Desktop\bakalauras\JourneyFy\src\screens\TemplateWallet\creditCard\creditCardScreen.js", "JavaScript", 0, 0, 0, 0, 0, -1, 1, 0
"c:\Users\Administrator\Desktop\bakalauras\JourneyFy\src\screens\TemplateWallet\paymentMethods\paymentMethodsScreen.js", "JavaScript", 1, 0, 0, 0, 0, -4, 1, -2
"c:\Users\Administrator\Desktop\bakalauras\JourneyFy\src\screens\TemplateWallet\successfullyAddAndSend\successfullyAddAndSendScreen.js", "JavaScript", 0, 0, 0, 0, 0, -1, 1, 0
"c:\Users\Administrator\Desktop\bakalauras\JourneyFy\src\screens\TemplateWallet\transactions\transactionsScreen.js", "JavaScript", 0, 0, 0, 0, 0, -1, 1, 0
"c:\Users\Administrator\Desktop\bakalauras\JourneyFy\src\services\firebase.tsx", "TypeScript JSX", 0, 0, 0, 0, 0, 0, -2, -2
"c:\Users\Administrator\Desktop\bakalauras\JourneyFy\src\services\firebaseUserService.js", "JavaScript", 2, 0, 0, 0, 0, 0, 0, 2
"c:\Users\Administrator\Desktop\bakalauras\JourneyFy\src\utils\formatTime.js", "JavaScript", 0, 0, 0, 0, 0, 0, 1, 1
"c:\Users\Administrator\Desktop\bakalauras\JourneyFy\src\utils\range.js", "JavaScript", 0, 0, 0, 0, 0, 0, 1, 1
"c:\Users\Administrator\Desktop\bakalauras\JourneyFy\src\utils\uploadImage.js", "JavaScript", 5, 0, 0, 0, 0, 0, 0, 5
"Total", "-", -496, 14, -17, -64590, -204, -658, -3944, -69895